a	若	落	世
b	不	还	分
c	到	又	对
d	的	在	大
e	并	总	半
f	都	去	地
g	更	子	跟
h	和	以	种
i	一	来	下
j	出	可	几
k	只	叫	吗
l	了	也	两
m	见	月	问
n	已	那	好
o	为	说	让
p	被	它	完
q	其	气	然
r	人	看	时
s	是	上	事
t	得	很	先
u	有	着	将
v	个	会	把
w	我	这	但
x	要	小	多
y	就	用	由
z	中	起	走
aa	匿	慝	苣
ab	共	节	恭
ac	莲	苔	茧
ad	惹	切	葬
ae	匹	菜	芸
af	芳	菲	芙
ag	苦	荪	菁
ah	燕	莉	芷
ai	薄	荡	萍
aj	蓝	匠	茁
ak	萼	荆	匡
al	苏	藉	苗
am	散	藤	蔺
an	藏	巨	蒸
ao	芝	蔼	弋
ap	蒙	荣	劳
aq	敬	警	擎
ar	草	昔	萌
as	萧	医	蔚
at	鏊	蓬	薇
au	蒋	茨	蒺
av	茶	苍	薛
aw	花	芒	荷
ax	区	药	东
ay	英	艺	芽
az	匮	蒉
ba	白	巴	八
bb	婴	凹	罂
bc	公	账	翁
bd	贫	盆	忿
be	贝
bf	赌	财	邀
bg	贼	贱	魄
bh	贴	赅	赕
bi	必	卫	歪
bj	则	赚	帛
bk	皇	否	遑
bl	赔	皎
bn	孬
bo	卜	赇
bp	贮	皖
bq	购	皂	赡
br	赐	贩	皈
bs	泉	赎	赆
bt	败	瞥	皓
bu	赠	贿
bv	欲	谷	迫
bx	爷	爹	父
by	甭
ca	长	厂	蝶
cb	愿	原	顾
cc	双	叠	轰
cd	参	叁	厦
ce	车	臣	输
cf	转	压	辱
cg	劲	戏	颈
ch	蝎	龇	蝌
ci	齿	虾	螳
cj	厅	斩	暂
ck	台	唇	售
cl	较	辆	劝
cm	能	观	熊
cn	鸡	虬	牟
co	集	虫	焦
cp	蛇	卧	辖
cq	软	欢	厮
cr	厚	遭	曹
cs	矣	熙	辗
ct	蜂	蝮
cu	垂	蜷	厥
cv	连	轮	轿
cw	厉	雁	龄
cx	邓	蟛	蚴
cy	通	勇	甬
da	刀	歹	奁
db	页	典	觍
dc	套	友	雄
dd	奄	鹌
de	夸	殓	瓠
df	夺	寿	奢
dg	左	存	残
dh	死	灰	秦
di	电
dj	段	奇	布
dk	右	召	哉
dl	面	戴	奋
dm	而	耐	耍
do	太	尤	态
dp	带	牵	殡
dq	殉	歼	殂
dr	百	春	蠢
ds	本	奔	泰
dt	忍	刃	奏
dv	达	殊	尬
dx	帮	爽	邦
dy	裁	殃
eb	貌	邈
ec	云	动	取
ed	须	貂	貊
ee	元	远	聪
ef	遥	豺	鹞
eg	乳	孚	郛
eh	丫	耿	耻
ei	剑	敛	佥
ej	判	叛	舀
ek	拿	命	合
el	爵	单	兽
em	愈	逾	俞
en	亏	妥
eo	采	彩
ep	受	爱	耽
eq	聊	豹	聒
er	儿	耳	二
es	遂
et	送	关	郑
ev	貔
ew	聆	貅
ex	弟	递	耶
ey	尊	普	聘
ez	聩
fa	方	猫	塔
fb	坏	费	犯
fc	却	发	辈
fd	犹	契	垮
fe	非	幸	坛
ff	替	猪	堵
fg	教	猜	缸
fh	老	坡	狄
fi	垣	圩	韭
fj	狮	狭	狎
fk	狂	袁	逛
fl	埋	境	培
fm	规	坍	猾
fn	场	块	缺
fo	过	狼	赤
fp	盐	坪	狞
fq	均	狗	艳
fr	者	煮	塌
fs	墙	款	堤
ft	放	施	旗
fu	夫	增	甫
fv	才	於	逋
fw	城	坟	斐
fx	悲	翡	邡
fy	坑	裴	猝
ga	干	戒	遮
gb	责	趴	靶
gc	库	张	弘
gd	项	跨	庆
ge	表	克	弹
gf	庄	鞋	废
gg	孤	巧	踱
gh	引	店	庐
gi	应	鞘	魈
gj	恐	刊	巩
gk	或	强	惑
gl	磨	摩	辜
gm	毒	青	静
gn	孔	嘏	鸪
go	床	某	工
gp	踪	鞍	蹿
gq	跑	底	跪
gr	座	踢	巫
gs	踏	踞	汞
gt	路	故	攻
gu	鬼	古	广
gv	退	跃	唐
gw	府	鹰	鞭
gx	素	孙	逊
gy	庙	序	弦
gz	跳
ha	虐	亥	烘
hb	具	秘	贞
hc	皮	私	颇
hd	烦	稽	燎
he	税	稻	禾
hf	房	烤	灶
hg	烧	季	煤
hh	此	步	收
hi	稍	炳	秣
hj	虎	利	灯
hk	点	占	战
hl	烟	炼	虏
hm	朝	肩	遍
hn	透	秀	委
ho	黑	墨	默
hp	壑	秤	熔
hq	称	粗	稳
hr	香	桌	旧
hs	疑	卢	熄
ht	乾	烙	炖
hu	火	乎	户
hv	炸	黏	遏
hw	韩	炜	虔
hx	移	扇	秒
hy	虚	稿	觑
hz	止
ia	满	港	灌
ib	激	测	溅
ic	治	汉	渐
id	无	梁	涛
ie	浮	尝	三
if	于	潜	沸
ig	清	江	湖
ih	正	淡	涉
ii	举	消	兴
ij	没	河	沿
ik	掌	党	常
il	画	滚	滴
im	尚	丽	滑
in	与	汤	汝
io	注	浪	末
ip	深	学	觉
iq	活	溜	泡
ir	再	派	混
is	泥	洁	漏
it	海	洗	洛
iu	溢	漾	滋
iv	当	澳	潘
iw	光	济	澄
ix	互	沙	洒
iy	酒	流	油
iz	囊	溃	洮
ja	既	暨	嵘
jb	即	击	岜
jc	紧	崖	帐
jd	顶	颊	炭
je	山	嵛
jf	峙	酆
jg	幅	毁	嵌
jh	顺	川	鼠
ji	及	师	兼
jj	刺	丁	帅
jk	哥	歌	帜
jl	勤	幢	舅
jm	岗	岚	崩
jn	鸭	岂	凯
jo	凡	朵	丸
jp	崇	崆
jq	欣	歉	峋
jr	帽	旭	臾
js	岩	杂	巅
jt	峰	临	监
ju	枣	嵯	馗
jv	进	近	归
jw	岭	峨	岑
jx	岁	幽	崤
jy	嵩	岫	幞
ka	开	弄	嗷
kb	吧	呗	嘤
kc	虽	叹	唉
kd	咧	嘎	琦
ke	兄	玩	形
kf	吐	哇	璇
kg	号	吼	呱
kh	喝	嘴	呼
ki	吓	吁	哨
kj	听	吸	吊
kk	王	琴	品
kl	别	另	理
km	骂	咪	玛
kn	哪	鸣	呐
ko	口	玉	呆
kp	喀	哝	喧
kq	哭	吻	吹
kr	唱	瑁	啤
ks	呢	叶	喷
kt	吃	吨	吴
ku	嗌	嗟	噌
kv	啥	响	珠
kw	喊	味	玮
kx	啊	吵	哟
ky	呀	哼	嚷
kz	珧
la	龚	耩	耢
lb	办	贯	耙
lc	变	颜	彦
ld	因	恩	辨
le	园	畔	聋
lf	里	团	野
lg	弯	固	靖
lh	站	罩	焚
li	力	立	吏
lj	端	耕	梵
lk	回	部	国
ll	男	田	童
lm	商	耗	麟
ln	楚	妾	鸾
lo	龙	颗	困
lp	旁	帝	啻
lq	蜀	麒	囫
lr	章	彰	赣
ls	新	亲	禁
lt	图	略	囤
lu	圈	囿	罾
lv	边	界	辽
lw	围	囹	圄
lx	梦	交	罗
ly	袭	耦	詈
ma	马	毛	瞒
mb	服	粉	盼
mc	瞧	睡	凤
md	类	骑	夙
me	脸	门	曰
mf	闺	肤	肪
mg	眼	精	睛
mh	骇	瞅	毯
mi	免	阔	肺
mj	股	盯	幕
mk	迥	闰	闾
ml	驰	粒	瞳
mm	闯	眯	朋
mn	数	断	肠
mo	莫	驻	闲
mp	腕	瞎	腔
mq	胸	睁	脆
mr	间	闪	胆
ms	驶	肢	摹
mt	阁	骆	糙
mu	目	母	料
mv	胜	迷	眨
mw	瞪	脑	阀
mx	风	刚	网
my	闹	丹	眩
mz	肿	眺
na	懂	慌	惜
nb	怕	怀	惶
nc	怪	姗	惭
nd	忧	怖	恢
ne	内	敢	悦
nf	特	娃	妨
ng	情	恨	姑
nh	民	改	妒
ni	鸟	牛	嫣
nj	岛	嫌	嫂
nk	如	恕	絮
nl	她	惯	愣
nm	眉	妈	姆
nn	快	飞	己
no	娘	枭	怵
np	嫁	婉	婶
nq	物	婚	姐
nr	慢	肉	婢
ns	承	愤	懒
nt	悔	牧	恪
nu	买	憎	嫉
nv	姓	性	孕
nw	忙	妹	怜
nx	姊	妙	嫖
ny	惊	忆	姨
nz	姚	忡	愦
oa	横	诺	栋
ob	杯	松	棉
oc	谁	树	权
od	椅	棒	诏
oe	检	谱	梯
of	诗	访	桂
og	根	李	良
oh	该	谈	核
oi	证	档	柄
oj	极	讲	机
ok	主	识	误
ol	校	谓	棵
om	想	相	模
on	之	记	词
oo	木	救	求
op	评	枕	棺
oq	话	构	檐
or	查	认	板
os	计	读	谢
ot	梅	格	枚
ou	栏	谥	槎
ov	许	枪	论
ow	语	诚	梧
ox	攀	樊	橡
oy	样	详	柚
oz	杖	桃	谴
pa	宽	窃	牒
pb	穴	赛	密
pc	室	军	鹤
pd	初	寄	劈
pe	衫	农	冠
pf	守	害	社
pg	字	定	空
ph	灾	褐	祯
pi	片	写	平
pj	宁	帘	祈
pk	宫	宝	祸
pl	穷	宠	宰
pm	视	臂	冤
pn	官	礼	案
po	宋	檗
pp	补
pq	突	袍	宜
pr	牌	版	冥
ps	神	家	宗
pt	客	额	宪
pu	寒	实	寝
pv	容	避	窗
pw	宿	察	衿
px	宛	祁	甯
py	裙	窘	譬
pz	窜	窕	祧
qa	错	昏	氏
qb	色	兵	迎
qc	县	勾	链
qd	留	贸	铸
qe	锐	饼	馁
qf	铺	基	铐
qg	钱	银	饶
qh	钻	乖	氮
qi	千	且	锁
qj	斯	钉	饥
qk	句	乱	锅
ql	重	锣	饺
qm	期	钢	馍
qn	甚	乌	斟
qo	卵	勺	乓
qp	馆	锭	氨
qq	饮	欺	钩
qr	忽	饭	旬
qs	包	针	镇
qt	锋	饰	乒
qu	曲	犬	炙
qv	急	铁	争
qw	饿	铃	镫
qx	尔	乐	镖
qy	久	解	角
qz	钟	馈	铫
ra	暴	冉
rb	掰
rc	反	返	晨
rd	照	昭
re	最	暖	昙
rf	暑	晡
rg	后	晴	晓
rh	爬	爪	彳
ri	日	晃	量
rj	昕	旯
rk	旺
rl	暗	曼	昱
rm	明	冒	盟
rn	所	暇	肏
ro	晰	杲
rp	晕	晏	暄
rq	易	昂	剔
rr	从	坐	耸
rs	早	质	遁
rt	昊	晦	晷
ru	曦
rv	星	昨	殷
rw	昧	晤	晟
rx	晒	昆	曜
ry	影	显	景
rz	晁
sa	展	碟	矩
sb	凼
sc	屋	支	翅
sd	题	硕	碘
se	身	层	碰
sf	射	博	屠
sg	硬	居	短
sh	真	直	破
si	石	十	士
sj	屈	刷	础
sk	知	吉	智
sl	鼻	协	磅
sm	南	尾	献
sn	声	局	馨
so	手	碴
sp	卡	勃	壹
sq	确	砍	臭
sr	碍	碑	沓
ss	犀	尉	尿
st	整	履	敕
su	水	书	束
sv	速	逐	矫
sw	碱	磴	韪
sx	叔	志	息
sy	尽	尺	届
sz	橐
ta	年	彻	簪
tb	徨	徼
tc	径	蚕	笞
td	顿	舞	筹
te	行	答	选
tf	等	待	徒
tg	筑	笺	竿
th	竹	篇	乍
ti	天	征	惩
tj	微	策	役
tk	各	靠	告
tl	备	务	笼
tm	每	算	笔
tn	筷
to	往	箱
tp	处	管	咎
tq	衔	衡	箕
tr	复	循	笪
ts	条	德	箫
tt	筅
tu	箭	冬	屯
tv	笑	州	御
tw	符	衙	篱
tx	第	篆
ty	乞	笛	篙
tz	篑
ua	冻	疟	痨
ub	卷	益	疤
uc	痛	准	冶
ud	头	美	凑
ue	兰	瘅
uf	凌	痣	瘀
ug	差	痕	痘
uh	凝	疲	痰
ui	病	症	痧
uj	瘦	疫	瘗
uk	况	癌	癍
ul	疗	瘸	瘴
um	前	剪	眷
un	决	羞	姜
uo	羹	羔	凇
up	癖
uq	次	净	资
ur	曾	脊	瘟
us	道	首	装
ut	疼	疙	冼
uu	羡	瘠	瘥
uv	凄	逆	疮
uw	冷	减	羚
ux	慈	翔	奖
uy	养	痒	癣
uz	冲	瘢
va	升	搭	拒
vb	拍	报	创
vc	么	摊	捶
vd	招	捧	乔
ve	摇	摄	拼
vf	挂	持	扶
vg	找	生	舍
vh	指	掉	灵
vi	抹	抚	挡
vj	打	投	折
vk	全	扣	操
vl	拉	摆	撞
vm	向	摸	奥
vn	追	扬	妻
vo	热	乏	拄
vp	扑	建	按
vq	换	抱	插
vr	抓	众	捏
vs	据	提	握
vt	拖	攒	掭
vu	抖	拦	搓
vv	抢	托	挺
vw	朱	挤	捂
vx	怎	系	批
vy	入	搞	余
vz	挑	执	搬
wa	万	借	供
wb	离	份	侧
wc	令	倒	仅
wd	体	优	例
we	未	文	偷
wf	佛	佳	侍
wg	便	做	感
wh	似	修	悠
wi	威	僵	俏
wj	何	仙	齐
wk	保	堡	赢
wl	他	使	俩
wm	望	们	佩
wn	成	件	仍
wo	住	休	仪
wp	仆	僻	倌
wq	你	您	低
wr	倡	俾	韫
ws	值	伸	什
wt	伤	佟	侮
wu	僧	兀	倦
wv	任	凭	健
ww	俄	伟	伍
wx	像	忘	倾
wy	袋	伊	亿
wz	仗	仲	佻
xa	陈	桀	绁
xb	凶	怨	贾
xc	经	阵	维
xd	尖	希	绮
xe	给	险	缓
xf	防	缚	纺
xg	红	线	隔
xh	比	皆	毕
xi	心	西	夕
xj	阿	级	陆
xk	名	喜	织
xl	练	细	绞
xm	阴	继	缕
xn	纳	纪	纽
xo	幻	幼	栗
xp	外	院	缩
xq	绝	约	组
xr	队	纵	阳
xs	杀	结	飘
xt	终	降	纯
xu	随	堕	肴
xv	少	省	绿
xw	附	纹	纬
xx	丝	羽	缘
xy	统	隅	纾
xz	缱	缋
ya	亚	牙	羊
yb	酚
yc	震	雅	酸
yd	需	预	酞
ye	衣	业	充
yf	霏	垩	鳍
yg	式	露	熟
yh	酥	酯	鳅
yi	乙	尹	夷
yj	市	霓	亢
yk	言	君	群
yl	雷	亩	颤
ym	高	敲	育
yn	配	霞	甩
yo	亦	霜	迹
yp	亮	亭	豪
yq	酌	鲍	雹
yr	醒	鲁	晋
yt	雾	酷	酬
yu	雨	鱼	予
yv	雪	柔	遇
yw	夜	零	雯
yx	邪	愚	邮
yy	醉	鲜	醇
yz	衷
za	丈	兆
zb	舶
zc	艚
zd	超
ze	趣
zg	赶
zh	越	赳	舻
zi	自	贵	趟
zj	般	船	艘
zl	艟
zm	盘	舰	盅
zo	舟	舣
zp	赴	舵
zq	趋
zr	舨
zu	艏
zv	逃	趁	舱
zx	赵	忠	舭
zy	航	舷
zz	串	患	舯
aai	葡萄酒
aay	葡萄牙	东莞市
abb	芭	葩
abc	蓊
abd	芬
abi	苤
abs	巷
abt	蔽
aca	蕻
acb	苊
acc	苌	劐
acf	蓐
acg	茎
ach	萑
acj	匦
acl	苈
aco	蕉
acu	蕨
adc	茇
adf	茬	薤
adg	荐
adh	蓁
adi	蓄电池
adk	苕
adn	萨达姆
ads	苯	萘
aeb	藐
aee	芫
aef	劳动者
aeg	莩
aei	莶	蔹
ael	劳动力	蕲
aen	荽
aer	茸
afb	菱
afd	莸	芏	葜
aff	匪	葑
afh	荻	蓍
afp	莆
afq	获	莰
afr	著
aft	蔟
afv	菸
aga	蔗
agg	菰	茛	苷
agl	共青团	蘼	蘑
agm	葫
agn	芤
agw	荛
agx	芎
ahg	葛
ahh	茈
ahk	苫
ahl	共和国	芦
ahm	匾
ahn	萎	莠
aho	苡
ahq	藜
ahs	蘧
ahx	蕙
aia	蕖
aib	范
aid	芜
aif	蒲	芋
aig	茳
aih	蔫	菠
aij	菏	芾
aik	藻
aim	莱
ain	廿
aio	茉	蒗
aiq	菹
air	蒎
aiu	艾滋病
aiv	藩
aiw	茫
aix	医学院	莎
ajc	芟
ajh	萜
ajj	芨	荚	艽	蒹
ajk	苛
ajm	芈
ajo	芄
ajq	芹
ajr	萸
ajx	匣
ajz	匝
akc	颧	鹳
ake	葺	蕺
akk	莒
akm	莴
akp	叵
ald	茵	颟	蒽
alf	薯
alh	菌
ali	共产党
alj	芝加哥
alk	茴	菩	茄
all	藕	荔	茏
aln	鹋
alp	蒂	薨	蒡	甍	瞢
alr	薏
als	薪	莘
alw	蔑
alx	萝	葸	茭
amb	菔
amg	茼
amk	苘
amm	蒯	苜
amn	薮	蒌
amo	菟
amq	苋
anb	贳
anc	薅
ang	菇
anh	蔬	苠
ani	茑
ank	茹
ann	葭	芑
anq	英特尔
anr	芮
ans	菡
anu	荬
anv	艿
aob	菘
aog	莨
aoj	菥
aok	艺术品
aom	葙
aop	艺术家
aou	苏格兰	英格兰
apb	薜
apc	萤	荤
apd	菪
ape	莞	蔻
apf	茔
aph	荧
api	萱	苎
apk	营	莹
apn	莺	菅	茕	荦
app	苹
aps	荥
apv	蓉	蓥
apw	蓿
apx	芯片组	萦	菀
aqa	莽	芪
aqb	蔸
aqc	苴
aqf	葡	萄
aqg	巨蟹座
aqh	薰
aqi	茚
aqj	萏
aqk	苟	檠
aql	董	蓟
aqm	菊
aqn	葚
aqo	芍
aqp	世锦赛
aqq	芊	萁	芡
aqr	葱	荀	芴
aqs	苞
aqv	茆
arc	苁
are	蕞
arf	莳
arl	蔓
arn	鹊	郾
arr	苒	菖
ars	萆
asc	董事长	芰	薙
asj	翳
ask	薹
asl	蔷
asp	荸
asq	蔌
ass	蒜
asv	董事会	蕤
asx	菽
asy	东南亚	荩
ata	敖
atb	赘
atc	螯
ate	荇	聱
atf	获得者
ath	蓰
atm	莓	骜	蘩
ato	熬
atp	菲律宾
atq	獒	蘅
atv	遨
aty	鳌
aum	蒴
avd	菝	荞
ave	荟
avf	荨	莛
avj	芥
avk	荃
avl	蓖
avm	黄金周	蕃
avn	孽	蘖	萋
avw	茱
avy	荼
awb	蓠	蒇
awc	苓
awe	莪
awf	苻
awh	莜
awi	葳
awj	荒	荠
awk	葆
awl	蓓	莅
awm	茂
awn	芩
awo	著作权
awp	英文版
awq	茯
awr	节假日
aws	蔡	茌
awt	葵
awv	荏
aww	苇
axa	艾
axb	苑
axf	荮
axg	荭
axh	荜	芘	蒈
axj	殴
axk	茗
axl	萨
axm	荫
axn	鸥	鸫
axq	欧	茜
axr	蕴	蕈
axt	莼
axv	芗
axw	瓯
axx	蕊	芯	蓼
ayb	黄
ayc	蘸	藿
ayd	蓣	薷
aye	茺
ayl	蕾
aym	蒿	藁
ayp	苄	葶
ayr	萃	蓑
ayv	茅
ayx	蓄	蕹
ayy	荑	藓
bbe	兕
bbn	鹦
bcb	不能不
bcd	颂
bck	贻
bcw	瓮
bcz	赈
bdd	颁
bdf	坌
bdh	不在乎
bdj	岔
bds	翱	皋
bdx	邠
bel	不动产
bff	赙
bgf	赃
bgx	兮
bhv	公积金
bil	财政部
bip	丕
biy	赋
bjc	不可能
bjn	皑
bke	贶
bkp	公开赛
blc	公交车
bly	分辨率
bmt	不见得
bmx	分数线
bpl	公安部
bpq	不定期	不客气
bps	公安局
bpv	不完全
bqq	不锈钢
bta	弊
btb	不得不	敝
btk	公务员	蹩	赂
btl	不得了
btn	不得已
btx	憋
bty	鳖
bvk	鹆
bvm	卫生间	皤
bvo	贬
bvs	赊
bvx	邳
bww	不仅仅
bxb	爸
bxe	婴幼儿
bxj	不要紧	斧
bxk	釜
bxl	不经意
bxn	必要性	嫑
byg	白羊座
byt	不由得
cab	弁
cac	蠖
cal	螨	蠛
cap	蝾	蠓
caq	蟒
car	蜡	厝
cay	蟥
cbc	能不能	对不对	蚣
cbe	厄
cbj	厕
cbk	蝗
cbt	逡	皴
cbz	对不起
ccb	轭	螈
ccc	桑	垒	辍	叕
ccf	轾	蛭	蛏
ccg	轻
ccn	难	蛑
ccr	螬
ccs	蜃	厍
ccw	蛎
ccy	蛹
cdb	颐
cde	毵
cdf	蝰
cdh	螓
cdk	龆
cdl	畚
cdr	蝽
cdt	轫
cdy	长春市
cec	册
ceg	蜉
cei	连云港
cek	蛤	蜕
cel	蝉	鬟
cem	蝓
cen	辰	辄
cep	鬓	鬃
ces	髻
cev	鬣
cey	允	蝤
cfb	蚌
cfd	臻
cff	辅	蛙	蚨
cfk	辕
cfo	怼
cfs	圣
cft	致	蝣
cfx	桑塔纳	郅
cfz	至
cgb	赜
cgg	双子座	蛄	轱
cgh	虹	蚓	蚶
cgj	艰	刭
cgk	蜮
cgl	蝠	辐
cgm	蜻	蝴	蜢
cgu	厨	蠊
cgv	迳	螗
cgw	蛲
cgx	轩
cgy	轻工业	龈
chj	蜊
chm	蝙
chs	轳
chx	蟪
chy	台北市
cif	参与者
cim	蛸
ciq	长三角
ciy	长沙市	邓丽君
cja	厩
cjf	堑
cjg	轨
cjh	螋
cji	蛳
cjj	蛱	虮
cjk	蚵	轲
cjo	椠
cjs	删
cjv	錾
ckb	轵
ckd	蝇
cke	辑
ckh	龊	炱
ckn	蜗
ckt	蜈
ckv	迨
ckx	怠	邰
clf	厘
clk	蛔	蝈
cll	历
clo	蜾
clp	螃
clr	蟑
clx	蛟	螺	辘
cmf	蜩
cmg	蛊
cmh	蚝
cmm	双胞胎	蟆	蚂	蠼
cmn	蝼
cmq	蚬
cmy	厦门市
cnr	蚋
cnv	隽
cny	轧	虼
coa	圣诞节
coc	叉	蚤
coj	螂	蜥
cok	通讯员	蛀
com	原材料	厢
coo	对讲机	对话框
cov	通讯录
cox	蚁
cpx	蜿
cqc	蟾	龀
cqd	靥
cqg	连锁店	魇
cqj	龃	厣
cqk	蛞
cqq	蛆	蛐	蚯	蜞
cqs	龅
cqw	餍
cqy	厌
crl	螟
crq	蜴
crr	蚺
crs	蜱
crw	到时候
crx	辊
csc	龌
csk	蜘
csm	蝻
csn	历史性
css	通知书
csx	螅
cto	通行证
cuq	蜣	劂
cus	圣斗士	蚪
cut	集装箱
cve	轸
cvf	轶
cvh	蜒
cvi	输入法
cvj	蚧
cvm	蟠	蟋
cvs	肆	蜓
cvw	蛛
cvy	蜍
cvz	蚱
cwb	螭
cwc	赝	蛉
cwj	蛴
cwk	龉
cwl	励
cwm	虻
cwq	晔
cww	蚊
cwy	蛾
cxh	蚍
cxo	压缩机
cxp	邓小平
cxs	连续剧	螵
cxw	通缉令
cxx	蟓
cyd	蠕
cyg	双鱼座	轼
cym	辙
cyo	台式机
cyp	连衣裙
cyq	龋
cyu	蟮
cyx	蟀	恿
cyy	蚜	蚰	蛘
cyz	轴
cza	集中营
dbd	百分百
dbh	百分点
dbl	大不了
dbn	秦皇岛
dbo	百分之
dbw	忍不住
dcd	面对面
dcj	截
dck	殆
dcy	大连市
dcz	载
dda	大本营
deg	殍
del	殚
den	刳	匏
dff	奎
dfo	大规模	焘
dfs	大都是
dgo	电路板
dgp	电子版
dhm	盔
dhv	本科生
div	大学生
djf	奉
djh	夼
djk	欹	剞
djl	列
djm	殁
djo	烈
djt	尴
djy	裂
dkb	殒
dkl	劭
dks	大理石
dkv	迢
dkx	邵
dlb	大部分
dlh	夯
dlk	殛
dmg	戛
dmj	恧	鸸
dmt	夏
dnn	灰姑娘
doo	电话机
dos	电话卡
dox	电话线
doz	栽
dpc	电视台
dpi	太平洋
dpo	电视机
dps	电视剧
dpt	百宝箱
dqo	尥
drx	电影院
dsh	殖
dsn	奈
dsp	殪
dtn	殇
dve	殄	餮
dvo	本报讯
dwq	大使馆
dwy	夏威夷
dxc	太阳能
dxi	大西洋
dxm	大多数
dzk	大中型
dzq	大自然
dzx	大中小
eal	运营商
ebn	总公司
ebs	并不是
ecc	聂	颞
ecg	魂
ecn	娶
eco	普通话
ecv	运	聚	鄹
edh	总面积
eed	顽
eek	运动员	总动员	鼋
eel	联合国
eem	运动服
eet	聊聊天	联
eev	运动会	联合会
ejd	耵
ejq	亓
ekb	职
ekd	颌
eke	兑
ekk	龢	龠
ekl	龛
ekm	盒
ekn	鸽
ekv	迸
ekw	元器件	瓶
ekx	翕	歙
elf	爱国者
els	郸	冁
emj	觎	毹
emm	貘
emq	觅
emy	合肥市
enf	爱好者
enl	动物园
enp	爱情片
eon	动植物
eot	二极管
epf	受害者
epj	聍
epx	舜
eqp	关键字
equ	爱尔兰
erd	聃
esl	二十四
eso	总书记
esw	半导体
esx	云南省
etk	貉
etp	聊天室
etu	二等奖
eup	半决赛
ewp	动作片
exj	剃
exk	总经理
exn	鹈
exo	奚
eyd	奠	猷
eyf	遵
eyq	酋
eyv	遒
fak	罐	獾
fan	堞
fap	獴
far	猎	堰
fbb	坝	狈
fbf	过不去	逵
fbi	放不下	坯
fcb	狻	塬
fcd	独	堆
fce	狁
fcf	蜚
fcl	劫	坜
fcm	盍
fcs	埃
fcu	獗
fcy	增长率
fdd	老太太	埯
fde	獠
fdj	猗
fdn	老百姓
fdo	发电机
fds	挈
feg	盩
fei	猃
fen	丰	圬
feo	发动机
feq	土耳其
ffb	埔
ffc	辇
fff	封	坊	狒
ffg	圭
ffk	猿
ffo	寺
ffp	卦
ffr	橥
fft	土	敷
ffv	慧	彗
ffx	恚
fga	犴
fgd	狨
fgg	狮子座	埂	犷	坩
fgh	狐	狠
fgk	考	域
fgm	猛	猢
fgq	猕
fgv	塘	墉
fgx	孝	狲
fhc	耋
fhd	发烧友
fhg	垓
fhh	罅
fhj	猁
fhk	坫
fhm	耄
fhr	耆
fhs	教科书	垆
fhv	逖
fhy	墟
fhz	址
fia	旅游区
fid	墚
fip	地下室
fja	教师节
fje	猊
fjh	圳
fjj	圾
fjk	坷
fjo	垛	坼
fjq	犰
fkb	埙
fkm	狷
fkn	埚
flf	狸	塄
flg	塆
fli	猥
fll	垃	垅
flm	猬
flo	猓
flr	獐	獍
flx	狡	猡
fmd	老朋友
fmg	垌
fmm	堋	犸
fmy	封闭式
fnf	狃
fnh	发改委
fnm	猸
fnn	圮
fob	赧
foc	寸
fof	赫	赭
fon	老板娘
foq	狱
for	猹
fot	赦	螫
fou	缶
fox	郝
foz	专
fpe	垸
fpf	狩
fph	坨
fpp	赤裸裸
fpx	地平线
fqa	坻
fqb	艴
fqh	獯
fqj	狙
fqk	坎
fqn	堪	坞
fqs	狍
fqv	狰
fqy	獬
frc	坂
frg	垢
fri	坦
frp	老人家
frq	埸
frr	猖
frv	猩
frx	翥
fsg	专卖店
fsh	填	埴	坭
fsj	堀
fsk	坤
fsp	教研室
fsq	獭
ftd	旖
fti	旆
ftm	旃	旄
ftn	旋
ftp	旅行社
ftq	旅	膂
ftr	老年人
fts	族	旎
ftv	旌
fty	旒
fuf	弗
fve	狯
fvg	猞
fvm	垧
fvp	埽
fvs	非金属
fvy	狳
fvz	方向盘
fwb	垴
fwd	方便面
fwh	增值税
fwn	猴
fxf	堙
fxh	狴
fyg	墩
fyk	壤	狺
fyl	教育部
fyp	壕
fyr	发言人
fyv	都市报	猱
fyw	专业化
gac	度
gaj	席
gak	工艺品
gal	蹒
gam	躏
gan	甘	距
gao	庶	鹧
gas	庹
gat	廒
gav	鞴
gax	广东省
gbg	贡
gcg	弪
gck	跆
gcs	跚
gcu	蹶
gcy	踊
gdb	顸
gdc	跋	魃
gdd	庵
gdf	踌
gdo	戎
gdq	青春期	座右铭
gdr	弼
gdv	鞑	跶
gec	蹑
geg	革	兢
gej	蹈	剋
gem	弭
gen	艮
geo	踩
gex	蹊
gff	趺	跬
gfg	孔夫子
gfi	疆
gfk	垦
ggh	弧
ggl	巧克力
ggm	麦克风
ggo	践
ggw	跷
ggz	孖
ghh	孩	跐	魆
ghj	工程师
gho	工具栏
ghp	庀
ghs	工具书
ght	工具箱
ghz	趾
gia	麦当劳
gid	张学友	庑
gin	麦当娜
gio	靺
gip	蹚
gix	青海省
gjd	踹
gjj	靳
gjl	廉
gjm	蹦
gjo	跺	蛩	跫	銎
gjq	廑
gjr	庾
gjt	趿
gkc	犟
gkk	躁
gkv	彧
gla	张国荣
glc	弛
glf	靡	廛
glg	功	魔
glj	副
glk	踣
gll	勒	魉
glm	麻	麾	糜
glo	踝
glp	蹄	庞
glq	躅
gls	工商局
glt	克林顿
glv	逼	麽
glx	跤	縻
gme	魍
gmg	粥	鬻
gmh	胡
gmm	孟	靓
gmn	鹕
gmp	靛
gmu	融
gnp	孙悟空
gny	青岛市
gog	戈	踉
goj	划	廊	戋
gom	盏
gon	弓
gov	座谈会
gph	跎
gpi	张家港
gpl	张家界
gqi	胡锦涛
gql	踵
gqm	鞠
gqs	庖	孢
gqx	弥	跞
gqy	廨
gri	靼
grk	张曼玉
grr	觋
grs	踬	庳
grx	蹋
gsc	庋
gsx	甘肃省
gte	跣	躜
gtk	鹭
gtm	麦
gtn	强制性
gtr	青年人
gty	广州市
gtz	孜
gua	瓜
gud	豆
gug	弱	豇
gul	强有力
gup	豌
gur	蹭
gus	魁	豉
guu	跆拳道
guv	逗
gvb	跄
gvc	摩托车
gvf	跌	瓞
gvs	庭	康
gvv	庚
gvy	庸
gwb	魑
gwc	膺
gwf	腐	跗
gwj	跻
gwl	工作站
gwm	魅
gwo	庥
gwp	工作室
gwq	靴
gwt	责任制
gwv	干什么
gww	责任感
gwx	工作组	翘
gwy	尧
gxf	麸
gxh	庇	邯	邗
gxk	邝	恳
gxl	廖
gxt	青少年
gya	工业区
gyd	孺
gyg	廓
gyk	路由器
gyl	工业园	廪
gyv	蹂	鞣
gyw	工业化
gyx	蹴	庠
gyy	鞅	赓
haj	收藏夹
han	炬
hbk	煌
hbo	积分榜
hbx	穆
hcg	雇	烃
hcl	火车站
hcz	烛	稚
hdb	颏
hdj	煅
hdm	以太网
hdo	嵇
heg	稃
hel	爝
hes	燧
hff	扉
hfl	房地产
hgg	秆
hgk	程序员
hgm	煳
hgo	戟
hgv	煺
hhb	北	匕
hhc	雌
hhd	颖
hhe	些
hhh	乘	剩	焱	燊	烀
hhj	剡
hhl	炉	冀
hhm	背	煸
hho	柴
hhq	秋
hhr	焯
hhs	砦
hht	频	颦
hhx	紫	愁	穗	煽	郯
hhy	炎
hip	科学家
hix	科学院
hjc	灿
hjd	颓
hje	彪
hjk	刻
hjn	犁
hjo	梨
hjt	秃
hjx	秽	炘
hjy	点击率
hkb	积	炽	扈
hkk	程	燥
hkl	稆
hkn	乩
hkq	启
hkt	虞
hkv	委员会
hlb	稷
hlh	劾
hli	黑龙江	煨
hlk	焙
hlm	熵
hln	卣
hlo	收音机	稞
hlt	畑
hlx	卤
hma	扁	翩
hmf	稠
hmk	肯	炯	扃
hmx	焖
hng	魏
hni	利物浦
hnq	炔
hnr	炀
hnv	逶
hoa	爆米花
hoc	黢	黪
hog	稂
hoj	黜
hok	炷
hol	黯
hon	积极性
hoo	称之为	秫
hos	黠	黩
how	黔
hox	黝	黟
hoy	黥
hpe	烷
hpi	睿	煊
hpn	稳定性
hps	稼
hpv	黑社会
hqc	炊
hqd	以色列	熘
hqj	焰
hql	戾
hqo	灼
hqs	炮
hqu	燃
hqv	黎	黧
hqx	歇	烁
hqy	焕
hqz	租
hra	爆
hrb	馚
hrg	焊
hrl	煜	熳
hrs	卓	稗
hrt	馥
hrw	馧
hrz	旨
hsc	秘书长	歧
hsd	颅	颍
hsh	稹
hsk	秸
hsl	穑
hsn	鸨	鸬	焗
hss	炻
hsv	启示录	遽	肄
hsy	烬
htf	烽
htp	糌
htq	肯德基
hts	税务局	称得上
htt	步行街
htv	肇
htx	綮
hue	烂
hul	战斗力
huo	战斗机
hus	科	戽
hvb	炝
hve	烩
hvf	秩
hvl	熜
hvm	燠	燔
hvo	刻录机
hvs	黍
hvu	斡
hvx	翰
hwk	焐
hwn	稔	焓
hwq	烨
hww	炆
hxc	餐	粲
hxd	稀	烯
hxe	黑名单
hxh	惠	秕
hxj	墨西哥
hxl	虑
hxv	炒
hxx	紫外线	熠	邶
hxz	秭
hyj	炕
hyk	燮	穰
hyq	歔
hyx	炫
hyy	北京市	秧	烊
iab	洪
iad	沏
iah	汇
ial	懑
ian	泄	渠	渫
iap	涝	濛	滢	潆
iaq	漭
ias	潇
iax	江苏省	沤
iay	潢
ibd	汾	湓
ibj	来不及
ibk	湟
ibm	泌
ibp	泊
ibv	浴
ibx	滏
icb	源	浚
icc	滩
icd	渗
icf	涯	溽
icg	注册表	泾
ich	淮
ici	一对一
icj	泽
icl	汽车站	沥
ico	游戏机	汊
icr	漕
icv	涟
icy	涌	湧
icz	一连串	浊
idb	粱
idd	淹
ide	潦
idf	一大堆
idh	溱
idj	洌
idk	沼
idl	湎
ido	汰
idp	滞
idr	一大早
idt	涩
idv	一大批
iec	滠
iee	沅	洱
iei	潋	湲
iej	滔	泮
iek	洽	瀹
iem	互联网	渝
ien	流动性	污
iev	没关系	淫
iex	溪	涕
ifc	法	泼	溘
ifd	一方面	漪
iff	消费者	洼	溥	沣	潴
ifg	一辈子
ifk	消费品
ifm	盂
ifp	浦
ifq	滟
ifr	渚
ift	游	漩
ifv	淤	迂
iga	渡
igb	渍
igc	涨	泓
igg	沽	泔
igh	汗
ign	鸿
igo	浅
igs	一路上
igt	潞
igu	溺	濂
igv	溏
igw	浇
ihb	浈
ihc	波	婆
ihh	沪	濒	湫	滹
ihi	焉	潲
ihk	沾	渴
ihm	灭	潮
ihn	丐
ihr	淖
ihs	泸
iht	政
ihv	常委会	瀚
ihx	河北省	湖北省	滤	瀣
ihz	沚
iia	海淀区
iib	誉
iic	港澳台
iig	一下子
iih	沔
iii	游泳池	润滑油
iij	沛
iim	淌	涞
iio	沫
iip	政治家
iir	洹
iix	浙江省
ija	溉
ijd	湍
ijg	一览表
ijh	溲
ijj	汲	浃
ijk	浏览器
ijo	染
ijr	派出所
ijs	汕
ijt	滥	汀
ijw	温哥华	涔
ijy	沂
ikb	赏
ikd	渑
ikf	堂
ikh	浞
ikk	澡
ikm	涓
ikn	涡
iko	棠
ikp	无理字
ikq	一口气
ikv	演唱会
ikw	汪
iky	裳
ilb	再也不
ilc	池	浐
ild	洇
ile	泗
ilg	满意度	湾	涸
ili	淠
ilk	涪	洄
ill	注意力	淋	潼
ilm	渭	潸
iln	漤
ilo	下意识	潜意识	滦
ilp	滂
ilq	三部曲	泣
ilr	泅	漳
ils	三国志	一回事	泷	溷
ilw	添加剂	涠
ilx	漉	漯
imb	淝
imc	濉
img	洞
imj	削	澜
imk	润	敞	氅
iml	泪	瀵
imm	一瞬间	漠	浼
imo	逦	郦	鹂
imr	涧
imv	逍
imx	肖	渺
inb	丙
ine	澉
inh	泯
ink	洳
inm	湄
inr	烫
ins	涵	汛
inx	海内外	邴
iob	淞
ioc	没想到
ioj	淅
iol	沩
iom	湘	沐
ioo	沭
ior	渣
ios	洛杉矶	泳
iov	漆	浒
ipa	黉
ipc	浑
ipe	浓	浣
ipg	淀
iph	沱
ipi	演	泻	渲
ipj	沉	泞
ipl	滓
ipn	涫
ipp	温家宝
ipq	沈	滨
ipr	一家人	溟
ips	淙	渖
ipv	溶
ipx	忑
iqb	浜
iqc	沟	澹
iqf	游乐场	淘
iqg	澧
iqi	三角洲
iqj	沮	澌
iqk	三角形
iqn	湛
iqo	一句话	柒
iqq	汽	淇
iqr	洵
iqv	泖
iqx	泺
iqy	无锡市	涣	澥
ira	瀑
irf	涅
iri	一日游	亘	湃
irl	漫
irm	一时间	温	汨
iro	无所谓
irx	溻
iry	湿	灏	汩
isc	渥
isg	潺
ish	滇
isj	涮	洎
isl	党支部	濞
ism	洗手间
isn	渎
iso	涿
isp	渤
isq	濑	漱	溴
isr	当事人
iss	汜	涑
isx	流水线	海南省	淑
isy	济南市
isz	汁
ita	洚
itd	沌
itj	来得及
itk	浩
itl	一条龙	沲
itm	滗
its	涤
itt	一天天	一条街
itu	三等奖	一等奖
itv	洲
itw	无条件
itx	一年级	添
ity	汔
iuf	混凝土
ium	溯	湔
iun	一次性
iuw	洧
iux	法兰西
iuy	汕头市
ivb	沧
ivd	一系列	沃	鋈
ive	一会儿	浍
ivf	浔
ivh	法拉利	涎	沦
ivj	津	浙
ivk	淦
ivl	淄
ivm	渊	洫
ivo	泛
ivp	浸
ivs	渌
ivv	一个个	活生生
ivw	洙
ivy	涂	溆
iwb	漓
iwc	泠
iwj	浏
iwk	瀛	浯
iwm	汶
iwp	辉
iws	源代码
iww	源文件
iwx	耀
iwy	濮
ixb	汹
ixc	潍
ixd	无线电	浠
ixe	澎
ixf	湮	澍
ixg	一阵子
ixl	泐
ixn	一刹那
ixo	溧
ixq	沁
ixr	潭
ixs	漂
ixu	淆
ixv	鲨	娑	裟	挲	滁
ixx	党组织	一阵阵	江西省	濯	汐
ixy	沈阳市
iyd	濡
iyg	淳	灞
iyh	武	鹉
iyj	沆	鎏
iyk	瀼
iyl	澶
iym	澈
iyn	一夜情
iyo	洗衣机
iyp	正式版	濠	汴
iyr	淬
iyw	液
iyx	泫
iyy	再就业	洋	渔	泱
izh	漶
izr	一般人
izy	党中央
jap	崂
jax	山东省	岖	岽
jay	舁
jbp	帕
jbs	岂不是
jbv	峪
jcb	贤	峻
jcc	崔
jcf	坚
jcg	岸
jcj	崭	峄
jcl	竖
jcm	肾
jcn	可能性
jcw	帷
jdb	颀
jdd	崦
jdf	帱
jdj	崎
jdm	遄	颛
jfh	出发点
jgb	帻
jgh	岵
jgw	嵬
jhb	帧
jhc	出租车	叟	帔
jhh	嵊
jhi	卅	蚩
jhk	帖
jhn	巍
jhs	嶷
jhu	鼹	鼬	鼢	鼯	鼷
jia	夹	甲	柬
jih	进一步
jij	臼
jim	峭	崃
jin	井	巾	斤	堇	屿
jiu	九
jjj	棘	岌	岬
jjk	进出口	岢
jjm	粜
jjo	帆
jjs	祟
jjv	岿
jjx	峡
jkq	岍
jlg	崮
jlk	帼
jlr	嶂	幛
jlx	崽
jmg	峒
jmn	嵝
jmq	觐	岘
jmx	嶙
jnh	岷	觊	剀
jni	鸠	鹣
jnj	峨眉山
jnm	嵋
jnn	屺
job	崧
joc	斥
joj	剁
jpi	九寨沟
jpn	出版物	兼容性
jpp	出版社
jqk	岣
jqo	舄
jqv	峥	峁
jrg	旮
jri	幌
jrl	幔
jrx	崑
jsb	豳
jsc	岐	幄
jsj	崛
jsp	杂志社
jti	近年来
jtm	览
jtn	可行性
jtv	鉴
jty	屹
jur	嵴
jux	嵫
jvd	峤
jvf	出入境	帙
jvm	幡	嶓
jvo	帕金森
jvy	嵌入式
jwg	嶝
jwi	崴
jww	帏
jxj	刿	郏
jxn	崾
jxx	山西省
jyg	崞
jyy	嵎	岈
kab	哄	珙
kad	喏
kae	嗒
kah	噶
kaj	咂
kak	哐
kal	喵
kan	喋
kap	唠
kaw	嗬
kax	哎	呕
kay	瑛	璜	呓	嚆
kbb	叭	璎
kbc	嗡
kbd	嗥	吩	玢
kbf	只不过
kbh	环
kbi	呸
kbk	叩
kbl	勋
kbp	珀
kbq	唣
kbs	碧
kbx	嗲	郧
kby	员	邑
kcb	呃	唆
kcc	啜	嗓
kce	吮
kcf	啭
kcl	呖	喱
kcn	啮	哞
kco	噍
kcr	嘈
kcs	珊
kct	唾
kcu	噘
kcv	琏
kcw	唯
kcy	嗵
kdb	嚣	顼
kde	嘹
kdf	喹
kdh	嗪	咴
kdj	唪
kdm	嗄	黾
kdo	呔
kdt	叨
kdv	哒
kec	嗫
kee	珥
kef	瑶
keg	戢
keh	吖
kei	瑗
kek	哈
kel	嚼
kem	瑜	喻
ken	鹗	鄂	颚
kep	嗳	瑷
kfa	开发区
kfb	哺
kfc	嗑	珐
kff	啡	呋
kfg	哮
kfh	嗜
kfl	开发商
kfo	哧	吋
kfr	嘟	啫
kft	嗾
kgb	啧
kgg	咕	瑰	哽	哏	玕
kgh	饕	吲
kgl	吸引力	嘛	嘞
kgm	瑚	嗝
kgt	璐	唛
kgv	瑭
kgw	哓
kgx	嗉
khc	玻
khd	啖
khh	啾	琰	呲
khj	唬	琥	琍
khk	咳	玷
khm	嘲	啃
kho	嘿
khq	唳
khs	噱	璩
khx	璨
khy	嘘
khz	足
kib	唢
kid	呒
kie	另一半
kih	另一种	啵
kim	琐
kin	玙
kip	噹
kiq	珠三角
kit	嗨
kiv	另一个	珰
kiw	咣
kix	唦
kiz	囔
kjb	唧
kjc	璀
kjd	瑞	喘	叮	玎
kjf	型
kjh	嗤	嗖
kjj	玑	咄	瑾	叽
kjk	班	呵	珂
kjm	嘣
kjo	哚
kjx	刑	呷	哕
kjz	咒
kkb	瑟	琶
kkc	咖啡厅	呈
kkf	足球场
kkk	噪	噩
kkl	吕
kko	珏
kkq	玻璃钢	咖啡馆
kku	呼吸道
kkv	逞
kkx	足球队	郢	琵
kld	嗯	咽
klf	哩	嘢
klg	鼍
kli	喂
klk	珈	咖
kll	琳	珑	叻	咙	啉
klm	喟	嘀
kln	唼
klp	啼
klr	噫	璋	喑
kls	噤
klx	咬	啰
kma	嗣
kmf	啁
kmm	呣
kmn	喽	鹃
kmq	现
knc	呶
knh	珉
knj	剐
knn	瑕
knv	叼
kog	琅
koj	啷
koo	球
kor	喳	唻
kos	咏
kow	班主任
kpb	琛	卟	嘧
kpc	珲
kpf	噻	嗐
kpg	啶
kpi	瑄
kpj	咛
kpn	咹
kpp	噼
kps	琮
kpv	咤
kpw	嚓
kpx	琬
kqc	叱
kqf	吠	啕
kqi	哈尔滨
kqj	嘶	咀
kqk	器
kqn	呜
kqq	琪
kqr	唿
kqs	咆
kqv	琤
kqy	唤	玖
kre	嘬
krq	哌
krr	唑
krx	琨
ksc	理事长	喔	吱
ksg	琚
ksh	嗔
ksj	唰	喇
ksk	咭
ksl	鄙
ksm	喃
kso	啄	琢
ksp	嗦	噎	咔	嚏
ksq	嗅	嗽
kss	呻	珅
ksx	啸
ksy	嘱	呎
ksz	咱
kte	瓒	珩
ktg	噬
ktk	珞	咯
ktm	玫
ktr	嘚
ktu	咚
kum	嗍
kvb	啪	呛
kve	珍	哙
kvj	哳
kvl	啦	璁
kvm	噢
kvq	吒
kvv	瑙
kvw	噙
kvz	咋
kwb	璃
kwc	玲	呤
kwf	咐
kwg	噔
kwj	哜
kwk	唔	斑
kwn	吟	喉
kwo	哦	咻
kwq	哗
kws	嘁
kww	现代化	玟
kwy	咿	玳
kxd	唏
kxe	嘭
kxh	哔	喈	吡	玭
kxk	嘻
kxo	呦	吆
kxq	吣
kxs	哂	喙	嘌
kxx	邢	哆	咝
kyc	嚯
kyd	嚅
kyj	琉	吭
kyk	唁
kym	唷	咩
kyp	嚎
kyr	噜	啐
kyu	噗	璞
kyx	琼	琊
kyy	咦	哑	喁
lax	新世纪
lbc	办公厅
lbd	棼
lbf	罘
lbh	办公桌
lbm	囧
lbo	办公楼
lbp	办公室
lbw	禁不住
lbz	了不起
lcb	竣
lcc	产
lce	衮	兖
lcf	耨
lck	变压器
lcm	蛮
ldd	罨
ldf	畴
ldg	瓣
ldh	意大利
ldj	畸
ldo	辩
lds	辣
ldw	毋
ldx	辫	恝
leb	彬
lec	耘
led	亲爱的	加拿大
lei	耒
lek	耠
les	四
lfc	罢	罴
lfe	圉
lff	畦
lfl	垄
lfo	立方米
lfp	圃
lfr	署
lfy	墅
lfz	罪
lga	国庆节
lgc	加工厂
lge	鹮
lgg	男孩子	罟
lgi	男子汉
lgl	孪	耱
lgm	羁	圊
lgz	耔
lhj	竭	麇
lhk	变频器
lhs	里程碑
lih	畏	罡
lij	畀
lil	加油站
lim	耥
lin	林
liu	六
liv	交流会
liw	新一代
lix	商学院
ljd	町
ljj	麂
ljl	峦
ljx	四川省
lkb	圆	贺
lkc	亟
lke	竞
lkj	加	剖	哿
lkm	驾
lko	架
lkv	迦
lkw	瓿
lky	袈
llf	新加坡
llg	圜
lll	勰	疃
lln	嬲
llp	耪
llx	四六级	麓
lmd	男朋友
lmk	驾驶员
lmm	麋
lmn	耧
lmw	胃
lmx	飒
lnc	罹
lni	国民党
lnl	娈	婪
lnm	因特网
lnn	囡
lnr	脔
lns	耜
lnv	回忆录
lnx	国内外
log	果
loj	罚
lok	麈
lol	栾
lox	夥
lpx	辽宁省	畹
lqp	音乐家
lqq	畎
lqs	音乐剧
lrc	畈
lrd	韶
lre	竟
lrq	韵	囚	歆
lrr	交易所
lrs	戆	鄣
lrv	交易会
lrx	意
lry	音
lsc	毅
lsf	麝
lsh	置	砉
lsl	挛	砻
lsm	罱
lsq	图书馆
lss	竦
lst	办事处
lsx	辛
ltt	畋
ltx	国务院
luh	国资委
lum	龙卷风
lve	畛
lvh	囵
lvj	孑
lvk	鏖	銮
lvo	交换机
lwn	罗伯特
lwp	新华社
lws	立体声
lxc	郴
lxf	鄜
lxh	鹿	毗
lxl	恋
lxo	累
lxs	思
lxt	效
lxu	新西兰
lxv	逻	耖
lxx	郊	翊
lyj	孓
lyw	产业化
mab	粪
mak	眶
mal	瞄
map	朦	矇
mar	腊
max	驱	眍
mbb	粑
mbf	肥
mbi	胚
mbk	凰
mbl	免不了
mbp	粕
mbs	腺
mbt	凸
mbu	睡不着
mcb	骏	睃
mcd	骖	糁
mcf	睚
mcg	胫
mch	睢
mcj	驿
mck	胎	骀	眙
mcm	闽
mcn	眸	毪
mco	骚
mcr	糟
mcw	粝
mcy	驭
mcz	胀	骓
mdc	闳	肱
mdd	腌	阉
mde	胯	瞭
mdf	目的地
mdl	腼
mdo	肽
mdt	驮
mdv	见面会	闼
mdw	朋友们
mec	骤
meg	脬
mei	验	睑
mej	胖
mek	脱	阅	骈
mel	阐
mem	腧
meo	风云榜	睬
mep	瞬	阌
met	朕
mew	闻
mex	睇
mey	氆
mfb	睦
mfc	脚	阖	瞌
mfd	肚
mff	膊	脯	腓
mfg	眭
mfk	周	雕
mfm	墓
mfo	肘
mfr	睹
mfv	闭	阏
mgf	脏
mgg	肝	肛
mgj	马鞍山	粳
mgk	阈	糨
mgl	马克思	骨子里
mgm	糊	膈
mgt	同
mgu	臁
mgv	腿	糖	糠
mgw	腑	骁
mgz	籽
mhh	骥	眦	阂
mhk	粘	毡
mhl	驴
mhm	骗
mhr	脂
mhs	胪
mhx	骟
mia	毛泽东	皿
mie	闫
mif	盱
mih	闪光灯	眄
mim	睐	骊
mip	瞠	膛
mis	闩
miv	同学录	同学会
miw	同学们	胱
mje	睨	阋
mjh	驯	瞍
mjj	肌	胛	肼
mjl	阑
mjr	腴
mjx	籼
mjz	闸
mkk	臊
mkn	脶
mlb	胁
mld	胭
mle	驷
mll	肋	眬	胧
mlm	勉	募
mlo	阃	骒	粿
mlp	膀
mlr	臆
mlx	胶	骡
mmc	瞿	矍	氍
mmd	髓
mmg	骨	胴	骷
mmh	骸
mmj	骰
mml	髑	髁
mmm	眼睁睁	蓦	膜	髅	毳	脒
mmn	鹏	鹘
mmp	髋	髂	髌
mmq	阒	骶
mmr	髀	骺
mmt	骼
mmv	骱
mmx	瞵	膦
mnd	鼎
mne	瞰	阚
mnh	眠	糈
mnl	同性恋	娄
mog	粮	阆
mon	鹇
mos	脉
mot	兔
mov	逸	膝
mow	周杰伦
mpc	膣
mpe	脓	脘
mpg	腚
mph	驼
mpn	胺
mpq	眈
mpr	瞑
mps	粽	腙
mpu	精神病
mqa	阍	胝
mqb	膑
mqc	瞻
mqd	骝
mqh	莫斯科
mqj	阎
mqk	驹
mql	阄
mqq	骐
mqs	胞	飑
mqv	驺
mqz	驵
mra	风景区
mrc	阊
mrm	暮
mrs	脾	睥
mrv	腥
mrx	风景线
msg	骣
msh	慕尼黑	阗
msm	腩
msp	脖
msq	糗
mss	脲
mst	豚
msu	糖尿病
msw	同志们
msy	瞩
mta	服务区
mtd	盹
mte	臜
mtk	服务器	服务员	胳
mtl	马德里
mtm	敉
mtr	腹
mty	服务业
mtz	肫
mul	免疫力
mum	腾
muo	糕
muq	阙
muw	罔
mux	糍
mvd	骄
mve	脍	胗
mvg	数据库
mvh	睫
mvl	骢
mvo	马拉松
mvp	腱	毽
mwf	驸
mwj	脐
mwm	闵
mwn	糇
mwq	骅
mwt	股份制	阕	睽
mww	闱
mxa	遴	粼
mxb	驳
mxc	眵
mxe	膨
mxg	冈
mxh	飚	飓	粃
mxj	飕
mxm	闷
mxn	腰	飏
mxo	慕
mxq	粉红色
mxs	瞟	膘	骠
mxv	眇
mxx	粞
myd	糯
mye	腻	彤
myg	骋
myj	肮	闶
myk	骧
myl	膻
myr	粹	氇
myu	膳
myv	糅
myw	腋
myx	臃
myy	胰
naf	好莱坞
nag	内蒙古
nai	嬅
naj	惬
nal	懵
nar	媾
nax	妪	怄
nbc	忪
nbi	内分泌
nbj	恻
nbn	好不好
nbr	蛋白质
nbt	恨不得	怪不得
ncb	悛
ncc	怅
ncd	惨
ncf	姪
ncg	弩	孥
ncj	姬	帑	怿
nck	始	怡
ncl	努
ncm	驽
ncn	奴	胬
nco	憔
ncq	恹
ncs	娠	拏	娭
ncw	惟
ncx	怒
ndg	惰
ndj	犄
ndk	怊
ndw	臧
ndx	好奇心
nec	慑	恸
nei	媛
nek	恰	姘
nel	惮	婵
nem	愉
nep	嫒
net	憨
nex	娣	悌
nfc	丑	怯
nfe	悻
nff	恃
nfh	姥
nfm	牡
nfo	忖
nfy	性教育
nge	婊
ngg	女孩子	牯
ngh	惦
ngj	奸
ngk	愧
ngl	嬷	嫲
ngm	婧
ngo	媒
ngs	司
ngv	慵	慷
ngw	娆
ngx	愫
nhb	惧	犋
nhc	蛋
nhd	爿	戕	奘
nhg	悸
nhh	愀
nhi	飞利浦
nhm	胥	犏
nho	姒
nhp	牝
nhr	嫌疑人	悼
nhu	牛皮癣
nhy	疏
nia	鹱
nid	妩	怃
nih	怔
nil	婳
nim	悄	惝
nip	嫦
nir	恒
niw	恍
nja	慨
njc	悭
njd	惴
njf	凫
njh	媸
njn	恺
njq	慊
nkb	悒
nke	愕
nki	物理学
nkm	娟	娲
nkt	娱
nky	妍
nla	特效药
nld	姻
nlf	悝	娌
nlg	嬛
nlh	妇产科
nll	憧
nlm	嫡
nln	憷
nlo	悃
nlr	嫜
nlx	姣	嫘
nmd	女朋友
nmf	惆
nmg	恫
nmi	牡丹江
nmm	嫫	牦	娩
nmn	鹛
nmo	娴
nmu	惘
nmv	性骚扰
nmw	悯
nnc	遐
nnf	妞	忸
nnh	婿
nnm	媚	乜
nnn	妃
nnv	奶
nnx	忌	娜
nog	悢
nol	妫
npc	恽
npp	怦
npq	嫔	忱
npv	姹
npx	惋
nqa	牴
nqc	忏	姽	恑
nqk	恬	忾
nql	娱乐圈
nqo	妁
nqr	恂	惚
nqy	懈
nra	情人节
nrc	娼
nrg	好日子	悍
nri	妲	怛
nrk	女人味
nrl	嫚
nrm	愠	媪
nrq	惕
nrv	惺
nry	憬
nsb	函
nsc	妓	忮
nsh	妮	慎	怩
nsi	丞	卺
nsl	嫱
nsm	娓
nsn	犊
nsp	悖
nss	悚
nst	嫩
nsv	迅
nsx	媳
ntk	飞行员	牿
ntr	愎
nvb	怆
nvc	盈	虱
nvd	娇	妖	刁
nvf	妇
nvg	牲	忤
nvh	婕
nvl	媲
nvm	恤	懊
nvn	女	乃
nvp	鸵	犍
nvq	快捷键
nvs	妊
nvw	姝
nvx	尕
nvz	怍
nwb	恼
nwe	娥
nwg	憾
nwk	悟	牾
nwm	牤
nwn	妗
nwp	牛仔裤
nwx	性价比
nxh	妣
nxj	婀
nxk	嬉
nxo	慄
nxs	慓
nxx	牺
nyd	懦
nye	袅
nyg	娉	惇
nyl	懔	嬗
nym	犒
nyo	孀
nyp	婷	忭
nyr	悴
nyy	妤	娅
nyz	妯
oab	栉	栱
oaf	榧
oai	桃花源
oak	框	诓
oan	柜	讵	谍
oap	檬
oaq	柩
oaw	谎
oax	枢	讴
oay	诸葛亮
obb	樱	柏
obc	想不到	讼
obd	槔
obf	檄
obi	说不清
obm	谧
obp	说不定	杷
obq	诺贝尔
obs	谈不上
ocb	梭
occ	栅	棰	枨
ocf	桎	柽
ocg	橱
ocj	译
ock	诒
ocl	枥
oco	樵	谯	杈
ocr	槽
ocs	榫	诶
ocu	橛
ocv	梿
ocy	桶	诵
ocz	椎
odh	榛	诙
odj	椴
odr	椿
odt	楱
odv	校友录
odx	梆
oec	机动车	诹
oef	求职者	谣
oeg	桴
oei	谖
oej	柈
oem	谕	榆
oes	杉
oex	椰
oey	樽	椪
ofb	棱	枋
ofd	杜	楔
off	诽
ofg	栲
ofh	栳
ofk	诳
ofo	村	讨
ofr	诸	楮
oft	主旋律
ofv	记者会	材
ofx	主教练
oga	概	诫	械
ogf	桩
ogg	杰克逊	杆	杠	梗	柑	诂
ogh	槐	讧
ogk	枯
ogm	请
ogo	谋	栈
ogr	诬
ogw	桡
ogx	朽
oha	谑
ohb	桢
ohh	楸
ohm	谝
ohn	诱	诿
ohr	诣	棹
ohs	栌
oii	榉
oik	樘
oim	梢	诮
oir	桓
oiw	桄
oix	桫
ojb	皙
ojc	设
ojd	订
ojh	训
ojj	谨	讥	谏	槿	桕
ojk	诃	柯
ojl	楝
ojm	朗
ojn	桤
ojo	许可证	诉	柝
ojq	谦
ojr	谀
ojt	槛	榄
ojv	证监会
ojx	郎	析	柙
okb	枳
oke	谔	楫
okg	枵
okk	调味品	榀
okr	机器人
okw	枉
okx	杏
olc	谚
olf	楞
olk	枷
oll	栊
olm	谪
olo	课
olp	榜	谛	谤
olr	谙	樟
ols	森	梓	榇
olt	说了算
olx	椤
omf	调	讽
omg	桐
omj	谰
omk	计数器	榈
oml	说服力
omm	棚	谟	橇	杩
omn	楼
omq	枧
omu	谗
omv	谜
omx	枫
one	橄
onj	诀
onl	植物园
onm	楣
onn	讷	杞
onr	杨	枘
ons	讯
onv	楹
onz	札
ooa	攀枝花
oof	槠
ooj	设计师	杰	榔
ook	柱
oom	米
oor	楂
oos	术
oov	述	逑
oow	机械化
oox	议
ooy	裘
opc	诨	榷
opf	讣
oph	柁
opi	楦
opj	柠
opn	桉
opp	朴	枰
opq	谊	槟
ops	棕
opv	诧	榨	榕
opw	檫
opx	检察院
oqa	柢	诋
oqc	诡	桅	谵
oqd	榴
oqj	谄
oqk	枸	栝
oql	橹
oqn	谌	椹
oqo	杓
oqq	棋
oqr	询
oqv	柳	诌	诤
oqx	栎
oqy	诺基亚	桷	槲
oqz	诅
orb	主人公
org	诟
orh	之所以
ori	栀
orl	谩
orq	麴
orr	枞
ors	说明书
orx	棍	榻
ory	杳
osb	标
osc	枝
osd	记事本
osf	榭
osg	椐
osh	植
osi	榍
osk	桔	诘
osl	樯
osm	楠	谳
osn	柰	椟
oso	诼
osq	主题曲
oss	樨
osx	椒
osy	永
osz	柘
ote	桁
otk	计算器	梏
otm	诲
oto	计算机
oty	杭州市	讫
ouq	谘
ouw	标准化
ovc	救护车
ovd	桥
ove	诊	桧
ovg	杵
ovh	诞	棂
ovk	栓	诠
ovn	槌
ovp	楗
ovr	主持人
ovs	棣	梃
ovw	株	诛	檎
ovz	诈	柞
owc	柃
owg	橙
owh	讳
own	权威性	谂
owq	讹	桦
ows	槭
owv	为什么
oww	杌
oxh	谐	楷	枇
oxl	想象力
oxr	谭
oxs	椽
oxu	椭
oxv	杪
oxx	栖	谬	诩	栩	橼
oxy	义
oye	樗
oyg	试	椁	谆
oyj	梳	杭	柿
oyl	檀	檩	檑
oym	槁
oyr	谇	榱
oyv	谲	橘	懋
oyw	格式化
oyx	谅	椋
oyy	讶	桠
oyz	杼
ozh	樾
pbc	蜜
pbf	宓
pbg	罕
pbv	裕
pcc	宸
pcf	窒
pch	宦	皲
pco	衩
pcx	郓
pdc	宏	祓
pde	寮
pdf	祷
pdk	祐
pdq	寡
pee	寇
pej	袢
pek	袷
pel	禅
pem	窬
pes	邃
pfb	壁
pfc	祛
pfd	禊
pfg	褂
pfk	割	豁
pfm	窥
pfo	平方米	衬
pfs	塞
pfy	窑
pgc	裤
pge	裱
pgg	窍
pgh	祜
pgk	襁
pgl	福	富
pgq	穹
pgv	褪
phf	牖
phh	褙
phl	客户端
phm	褊
phz	祉
pif	宇
pim	宵
pio	袜
pip	辟
pir	宣
piv	裆
piy	宁波市	寅
pjg	宄
pjj	平顶山	究
pjr	冗
pjt	褴
pke	祝
pkh	蹇
pkn	窝
pko	璧
plg	寰
plk	农产品
plo	裸	窠	祼
plr	窨
pls	襟
pmm	寞
pmn	褛	窭
pmp	实验室
pmq	骞
pmr	裥
pna	安
pnb	嬖
pnd	避孕套
png	农民工	祠
pnh	寐	寤
pnl	牢
pnv	逭
pnw	初始化
ppo	写字楼
ppy	平安夜
pqa	祗	祇
pqb	宾
pqn	鸩
pqq	祺
pqx	祢
pqz	祖
prd	幂
pri	袒
prn	实质性	宴
prs	裨
psb	擘
psc	富士通
psd	宕
psj	窟
psn	突破性	窦	牍
pso	冢
psq	搴
pss	审	祀
psx	寂
psz	寨
ptk	窖	袼
ptx	安徽省
puo	禚
puy	宥
pvd	安全套	袄	祆
pvk	鐾
pvm	窸
pvo	窆
pvq	宅
pvs	禄	衽
pvw	社会化	安全感
pvx	福建省
pvz	窄	祚
pwk	褓
pwn	农作物
pwp	甓
pwq	袱
pwy	祎
pxb	剜
pxk	禧
pxl	寥
pxo	窈
pxt	窿
pxv	实习生
pyc	穿
pye	褰	襞
pyk	禳	謇
pyr	窣
pyx	袖	祥
pyy	寓
pyz	宙
qac	镬
qad	锘
qak	钷
qal	锚
qam	馓
qan	钜
qao	邸	鸱	氐
qap	铹
qaw	铓
qbb	钯	钚	钡	铂	铋
qbd	氛
qbf	负
qbj	锦	铡
qbn	兜
qby	卬
qcb	危	詹
qcc	锤
qcg	氢
qcj	铎	雎
qck	饴
qcl	急转弯
qcn	针对性	镌
qco	钗
qcs	蚀
qcu	镢
qcx	悬
qcz	锥
qdc	钹
qde	镣
qdi	锂电池
qdj	锻	钸
qdl	遛
qdo	钛
qds	钵	锛
qec	镊
qee	饵	铒
qef	锊
qei	锾
qek	铪	镎	饸
qes	钐
qev	铝合金
qex	锑
qey	镨
qfb	镄
qfd	锲
qff	氟	钫
qfh	铑
qfp	解放军	匍
qfr	锗
qft	镞	钍	镟
qga	镀
qge	氪
qgg	钴
qgk	镪
qgl	匐
qgm	锰	氰	镉	锖
qgo	饯
qgq	钳
qgr	负责人
qgu	乌克兰	镰
qgv	镛
qgw	铙
qgy	重庆市
qhc	铍
qhg	钺
qhh	锹	氦	钬
qhn	锈
qho	熏
qht	锬
qia	欠
qib	印
qih	钙	钲
qim	销	铼
qin	铴
qip	镗
qiq	七
qiu	丘
qiv	留学生	铛
qiz	馕
qjc	铿
qjd	氘
qjh	馊	钏	氚	锼
qjj	钾	馑	铗
qjk	铅	钶
qjm	镚
qjn	铠
qjo	钒
qjq	锨	歃
qjx	氙
qjy	岳
qjz	钊
qke	锷
qkg	甜
qkj	刮	铞
qkk	铝	锃
qkl	辞	劬
qkn	鸹	鸲
qko	钰
qkq	舐
qks	舌	憩
qkt	敌	舔
qkv	适
qkx	够
qlc	铲
qld	氤	铟
qlf	锂
qlg	锢
qlk	锫
qll	钌
qlm	镝
qln	龟
qlo	锞
qlp	镑
qlq	镯
qlr	镜	镱
qls	锌	甸	锶
qlt	钿
qlx	镳	铰	镙
qlz	助
qmg	铜
qmj	镧
qmk	锎
qmm	钼	镆	钔
qmn	镂
qmr	锏
qmu	馋
qmy	钥
qnf	钮
qng	饲	戡	钆
qnk	铷
qnl	勘
qnm	镅
qnn	钠	钕
qnq	詹姆斯
qnr	饧
qnv	邬	氖
qog	锒
qop	锦标赛
qor	馇
qov	孵
qph	铊
qpn	铵
qpp	钋
qpq	镔
qps	镓
qpv	镕
qpw	镲
qpz	镩
qqb	飙	铯
qqd	馏	镏
qqj	馅	锸
qqk	乒乓球
qql	锺	锄
qqn	钨
qqo	钓
qqq	钦	钎
qqr	锪
qqs	饱
qqu	钧
qqv	铮	铆
qqx	铄	饩
qrc	钣
qri	钽	锝
qrj	刎
qrl	馒	镘
qrm	氲
qro	匆
qrq	锡
qrr	锉
qrw	勿
qrx	重量级	馄	郇	锟
qsf	基督教
qsg	锯
qsh	铌
qsj	刨
qsn	锔
qso	饮水机	镍
qsp	饽
qsq	碁
qss	馔
qtd	钝
qte	铣
qth	气管炎
qtk	铬	锆	饹
qtl	饬
qtt	饨
qtu	氡
qub	镒	锩
qud	镁
qun	馐
qus	钭
qux	锵
quy	匀	铕
qvb	卯
qvc	雏	刍
qvd	饫
qvf	铥
qvh	皱
qvj	卿
qvk	铨
qvl	锱
qvm	饷
qvo	解释权
qvp	键	锓	氕
qvq	迁
qvs	氯	铤	饪
qvt	煞
qvv	基金会	秉
qvw	铢
qvx	邹
qvy	馀
qwe	锇
qwn	钤	铖
qwq	铧
qxb	匈
qxh	锴
qxj	锕
qxk	铭	玺
qxo	綦
qxq	邱
qxr	镡
qxs	铩
qxv	钞	迩
qxx	镠
qyc	触
qyd	留言本	蟹	邂
qye	锿	铱	铳
qyg	镦
qyh	匈牙利	灸	奂
qyj	钪	铈	锍
qyk	适配器	镶	訇
qyl	镭
qym	镐
qyo	留言板
qyr	镥
qys	饮用水
qyt	留言簿	觞
qyu	镤
qyx	铉	铘	铽
qyy	铀	氧	氩	钇
ram	人世间
rbc	看不到
rbm	看不见
rbr	时不时
rbz	看不起
rcr	昃
rcv	暹
rdf	所在地
rdw	最大化
rep	暧
rfi	反过来
rgh	旱	旰
rgk	旷
rgv	逅
rhg	时刻表
rhj	炅
rib	卮
rid	旦
rif	拜
rkl	影响力
rlf	曙
rlr	看了看
rmg	时间表
rml	勖
rmm	冕
rmw	晚
rnv	人民币
rod	日记本
rog	看样子
roo	照相机
rpc	晖
rpr	暝
rqe	星期二
rqh	曛
rqi	星期一	星期三
rqk	煦
rql	星期六	星期四
rqr	星期日	曷
rqt	星期天
rqu	昀
rqv	昴
rqw	星期五
rra	曝
rrc	昌
rri	丛
rrq	俎
rrr	晶
rrx	怂
rry	昆明市
rsb	卑
rsf	看上去
rsh	昵
rsk	显示器
rsm	盾
rsn	鹎
rss	显示屏
rsx	郫
rtc	看得到
rth	所得税
rtq	显微镜	景德镇
ruo	所有权
rva	昇
rvc	人生观
rvg	戥
rvm	晌
rwm	旻
rwn	晗
rwt	暌
rww	最低价
rxx	遢
ryg	暾
ryk	日用品	曩
ryx	晾	颢
ryy	映
rzu	后遗症
sab	殿	臀	贲
sad	砌
sah	卉
sai	礴
saj	砸
san	屉	榘
sap	礞
saw	硭	礤
sax	躯	砹
say	异	磺
sbs	矿泉水	是不是
scc	直通车	砗	磉
scd	碓	碜
sco	礁
scw	砺
scz	雉
seg	水瓶座
sei	硷
sek	屏
sem	十二月
sen	申
sfc	磕	砝
sff	硅
sfm	局域网
sfo	导	砖
sgb	碛
sgg	躬	孱	矸
sgh	矧
sgj	剧
sgk	矿
sgm	碡
sgw	硗
shb	颠
shj	碣
shk	砧
shm	碥
shn	尼	矮
shs	匙	矗
sht	丧
shv	居委会
sia	磲
sii	上海滩
sik	上下班
sil	礓
sim	躺	屑	硝
sis	史	尸	示	矢	巳	豕
siy	上海市
sjd	碳
sjj	矶
sjk	尻	砢
sjl	剌
sjo	躲	矾
sjv	博览会	展览会
sjx	硖
sjz	斫
skf	上班族
skj	硎	屌
sks	喆
sky	研
slc	勅	磙
sli	鼾	劓	齁
slk	水产品	啬	碚
sll	砬
slp	碲
sls	墼	軎
slx	吉林省
smf	碉
smg	硐
smm	码	硼
smn	屡
smq	砚
sms	屎
smx	磷	砜
snj	磬	罄	謦
snq	博物馆
snr	矿物质	畅	砀
snu	卖	觌
sor	申请人
sos	申请书
sov	研讨会
spb	屄
spc	毂
spg	石家庄	懿	碇	孛	鹁
sph	砣
spi	彀	觳	碹	榖
spj	壳	悫
spk	研究员
spp	研究室	砰
spr	研究所
spv	研究生	研究会
spx	研究院	碗	索
spy	壶
sqa	砥
sqb	赖
sqn	磡
sqs	畅销书
sqx	砾
srr	矬
ssa	巽	碾
ssb	泵
ssf	慰	熨
ssg	射手座
ssh	燹
ssr	博士后
sss	磊	砷	淼
ssv	博士生
std	砘
sth	屣
stk	硌
stm	屦
str	事务所
sts	屐
sug	磋
sus	肃
sux	磁
svg	砼
svl	硇
svo	砭
svs	碌
svw	硃
svz	砟
swo	身份证
sws	短信息
sww	硪
sxa	磔
sxc	督
sxf	手续费
sxg	知名度
sxh	屁	砒
sxj	屙
sxt	忐
sxv	砂
sxx	硒
syg	礅
syj	硫
syk	咫
syl	事业部
syr	碎	昼
syu	羼
syv	迟
syy	南京市	砑
syz	属
tab	衖
tak	筐	笸
tao	天花板
tbc	得不到
tcr	年轻人
tdk	笤
tds	笨
tef	徭
tei	签
tet	赞
tez	竺
tff	彿
tfj	街
tfp	彷	徘
tfr	箸
tft	簇
tfv	逢
tgr	筮
tgx	筇
thc	彼
thg	天秤座
thh	徙
tia	行政区
tie	衍	愆
tif	第三者	竽
tih	微波炉	第一步
tim	徜	徕
tit	第一条
tiy	天津市
tji	徽	徵	筛
tjj	制	掣	笈
tjn	先进性
tjt	篮
tkb	筼
tkf	管理费
tkk	管理员	处理器
tks	管理层
tkt	吞
tkv	造
tkx	郜
tla	籍
tlk	徊	笳
tll	笠
tlp	徬
tlv	迤
tlw	篾
tlx	箩	惫	簏
tmd	笃	篡
tmg	筒
tml	筋
tmm	笑眯眯	衢
tmn	篓
tmq	笕
tmr	年月日	简
tmt	敏	繁
tmy	毓
tng	处女座
tod	笔记本
tpm	天安门
tqc	徂
tql	赞助商
tqo	复印机
tqq	天然气
tqr	徇
tqv	筝
tqw	复印件
trh	笊
ttl	制造商
tty	制造业
tva	箍
tvg	笙
tvh	筵
tvk	筌
tvl	律
tvn	微生物
tvy	徐
twg	筏
twv	备忘录
txr	每小时
tys	笋
tyv	迄
tyy	徉
uae	瘩
uay	癀
ubb	瘿
ubj	疖
ubk	痞
ubq	前不久
ubv	决不会
ubx	差不多
ucb	羧
ucc	瘫
ucd	瘆
ucg	痉	羟
ucl	疬
uco	瘙
udj	冽
udm	前列腺
udo	疣
udq	券
uel	凝聚力
ufd	瘛
uff	痔	痱
ugg	疳
uhg	羲
uhh	疵
uhj	痢
uhn	痿
uih	差一点
uiu	有没有
uiv	奖学金
uix	冱
ujd	疔
ujk	疴
ujr	瘐
ujs	疝
ulg	痼
uli	痹
ulk	痂
ulm	痳
ulq	有效期
ulr	癔
ult	前两天
ulx	瘰
umf	冯	塑	凋
umg	资料库	盖
umj	煎	翦
umm	癯	瘼
umn	瘘
umo	槊	痫
ums	朔
umw	塑料袋
umx	疯
unn	瘕
unq	羌
unr	疡
unz	妆
uok	疰
uoq	美术馆
upx	美容院
uqd	瘤
uqj	疽
uqk	咨
uqm	盗	粢
uqn	姿
uqr	有钱人
uqs	疱
uqw	瓷
uqx	恣
uqy	疚	痪
uqz	状
uri	疸
urr	痤
urw	有时候	甑
ury	美人鱼
usa	癜
usb	冰
usd	斗
ush	癫
usj	疾	瘌
usk	痴
uso	瘃
usq	拳	癞
usv	瘪
usz	壮
uve	疹
uvh	郁金香
uvj	疥
uvk	痊
uvz	痄
uwk	痦
uwl	疠
uwn	瘊
uws	瘵
uxc	瘳
uxn	美少女
uxo	兹	桨
uxq	瘾
uxs	浆	瘭
uxt	癃
uxy	郁	恙	酱
uyk	誊
uyl	凛
uyr	瘁
uyx	凉	痃
uyy	痈	痍
vab	拱
val	描
vam	撒
van	揲
vap	捞
var	措	揠
vav	搽
vax	抠
vbb	扒
vbc	仓
vbd	扮
vbg	戗
vbt	舍不得	撇
vca	拚
vcb	扼
vcc	掇	搡
vcd	掺
vcf	捱	捯
vcj	择
vck	抬
vcn	携
vco	搔
vcs	挨
vct	推
vcu	撅
vcy	捅
vcz	振	蛰
vdc	拔
vdd	掩
vde	撩	挎
vdj	岙	掎
vdo	扰
vds	捺
vdt	揍
vdv	挞
vdy	夭
vec	刽	郐
vef	捋
vei	捡	援
vej	拌
vek	拾
vel	生命力	掸
vem	揄
vep	授
ves	伞
vet	掷
vev	奥运会
vex	揶
vey	撙
vfb	捕
vfc	丢	拨
vfd	垫
vff	拂	搏	撵
vfg	拷
vfh	奥地利
vfk	播放器
vfl	批发商
vfo	寻	挝	抟
vfp	排
vfs	失
vfv	迭
vfw	全方位
vga	摭
vgg	扛
vgh	卸	掂
vgk	舒	扩
vgl	全攻略	甥
vgm	眚
vgv	搪	迕
vgw	午	挠
vhc	扯	披
vhh	护	揪
vhj	揭
vhk	拈
vhl	掳	仑
vhm	掮
vho	打火机	拟
vhp	延
vhq	企	捩
vhv	擀
vhx	搧	摅
vif	生活费
vik	撑
vim	捎
vip	哲学家	搅
viw	禽流感
viz	攮
vjb	币
vjc	摧	蜇
vjd	揣
vjh	搜
vjj	介	拙	搛
vjk	哲	踅
vjl	抛
vjo	拆
vjq	掀
vjt	揽
vjv	逝
vjx	挟
vjy	押	誓
vkb	损	挹	邕
vke	金	揖	鑫
vkh	捉
vkl	捌	拐
vkm	捐
vld	摁
vlf	睾
vlg	擐
vlj	拣
vlk	掴	掊
vll	生产力	生产商	拢
vlm	摘	粤
vln	全国性	接
vlo	捆	巢	剿
vlr	揞
vls	势	掼
vlt	撂
vlu	打交道
vlx	生产线	摞	邋	囱	囟
vlz	甾
vmc	释
vme	衅
vml	翻	番
vmm	撬	拇	扪
vmn	搂	擞	衄
vmt	搁
vmu	搀
vmw	挽
vmx	血	悉	鄱
vmy	釉
vne	撖
vnf	扭
vng	金牛座
vnh	抿
vni	生物学
vnj	捣	抉
vns	阜	拯
vnv	扔
vnx	挪
vnz	扎
voj	会计师
vor	揸
vpb	探
vpc	挥
vpf	金字塔
vpg	控
vpi	揎
vpj	拧	帚
vpp	抨
vpq	摈
vpw	擦
vpy	挖
vpz	撺
vqa	抵
vqb	抑
vqf	掏
vqj	撕	掐
vqk	拘	括
vql	撸
vqm	掬
vqo	打印机
vqq	揿	扦
vqs	奥斯卡
vqv	挣
vrc	扳
vre	撮
vrg	捍
vrh	搋
vri	担
vrj	摄影师
vrr	挫
vrs	捭
vrt	全日制
vsa	搌
vsc	技	抻
vse	摒
vsh	指示灯
vsj	剥	掘
vsk	扬声器	热水器	撷	拮
vsl	录	隶	擤
vsp	热身赛	廷	拤
vsr	壬
vss	佘
vst	拓
vsv	逮	逯
vsy	企事业
vsz	挚	撰
vtj	建筑师
vtn	创造性	建筑物
vto	排行榜
vtr	招待所
vtw	全天候
vuf	投资者
vum	搠
vvd	挢
vvg	抗生素
vvh	捷	抡
vvk	拴
vvl	怎么办	指挥部
vvm	播
vvo	怎么样	拖拉机
vvs	扫
vvw	擒
vvx	巡	拶
vwb	禽
vwc	拎
vwf	拊
vwg	撼
vwn	捻
vwo	摄像机
vwt	揆
vwu	摄像头
vwx	邾
vxh	揩
vxo	拗	胤
vxs	掾
vxv	抄
vxx	摺	擢
vyc	抽	叙	攉
vyf	创业者
vyg	拭
vyj	抗
vyk	攘	捃
vyl	擅	擂	甪
vym	撤
vyo	企业主
vyp	企业家
vyr	捽
vys	抒
vyu	斜
vyv	途	揉
vyw	掖
vyx	摔	掠	搐
vyy	拥	拽
vze	全自动
waa	僭
wad	偌
wan	亡
waq	儆
war	偃
wat	傲
waw	瓦
wax	伛
wbb	伯
wbk	离不开
wbl	忘不了
wbm	佾
wbv	俗
wcb	俊
wcc	傩	伥	虿
wcd	领
wcf	停车场	侄
wck	保龄球
wcn	侔
wco	僬
wcs	俟
wcw	瓴
wcx	邻	翎
wcy	俑
wdd	俺
wde	僚	侉
wdf	俦
wdg	佐
wdj	倚	俸
wdk	佑
wdm	斋
wdn	齐达内
wdr	佰
wds	傣
wdt	仞	韧
wec	舆
weg	俘
wei	韦	俭
wej	伴	韬
wem	爨	璺
wen	佞	佴
weq	望远镜
wer	仁
wes	盥
wew	我爱你
wfc	佉
wff	傅	仿
wfh	佬
wfo	传	付
wfp	俳
wfy	成都市
wgb	债
wgc	化工厂
wgg	估	傀
wgl	供应商
wgm	倩
wgo	伐	垡
wgq	供应链
wgu	登	凳
wgw	俯	侥
wgx	咸
wgy	食
wgz	仔
wha	保税区
whb	俱	侦
whh	伙
whj	俐	偈
whm	偏
whn	候	倭
whr	倬
wht	倏	攸
wie	偿	仨
wik	傥
wim	倘	俪
wiu	传染病
wiy	斌
wjc	仇	催
wjd	仃
wje	倪
wjj	剂
wjl	刘
wjt	这几年
wjx	侠
wjy	佛山市
wjz	仉
wkh	促	趸
wkj	侃
wkk	侣
wkl	吝
wkm	嬴	羸	蠃
wko	煲
wkt	俣
wkw	吾
wlf	俚
wlg	儇
wli	偎
wlk	倍	伽
wll	僮	儡	仂
wlm	劢
wlo	倮
wlp	傍
wlq	俄罗斯
wlt	佃
wlw	位
wlx	佼	偲
wmf	倜
wmg	侗
wmh	肓
wmj	斓
wmm	盲
wmn	偻
wnb	贪
wnd	他妈的
wng	伺
wnh	氓
wni	侯
wnj	今
wnk	含	颔
wnm	盛
wnn	假
wnw	妄	鹅
wnx	念
wny	衾
wof	储
wol	伪
won	鸺
woo	俅
wos	戍
wov	保证金
wpe	侬
wpg	倥
wph	佗
wpi	伫
wpq	傧
wqb	货	仰
wqc	儋
wqf	伏
wqh	化
wqk	佝
wql	俱乐部	伊甸园
wqq	仟
wqr	偬
wqs	华
wqt	华尔街
wrx	五星级
wsa	偾
wsc	伎
wsf	领导者
wsg	倨
wsh	伲
wsj	倔
wsk	佶
wso	传真机
wsp	佧
wss	仕
wsw	信息化
wsx	蹙	戚
wsz	祭
wtc	万年历	嫠
wtg	癸
wtr	候选人
wtw	刘德华
wty	仡
wuk	化妆品
wuw	戊	五
wuy	侑
wva	保护区
wvb	伧
wvc	仫
wvd	侨
wve	侩
wvf	佚	齑
wvg	伊拉克	仵
wvh	伦	倢
wvj	价
wvl	傻
wvm	迈
wvp	侵
wvs	恁	赁
wvw	违	侏
wvy	便携式
wvz	作
wwa	文化节
wwc	价值观	伶
wwj	文件夹	侪
wwk	传感器
wws	傺
wwt	华盛顿
wwv	凭什么
www	催化剂	佤
wxc	侈
wxh	偕	仳
wxk	僖
wxm	邙	僳
wxo	紊	傈
wyb	贷
wyd	代	儒
wye	依
wyf	体育场
wyg	俜
wyh	黛
wyj	岱	伉
wyk	信
wyn	牮
wyo	使用权	偶
wyp	停
wyq	体育馆
wys	信用卡
wyv	俨
wyx	僦
wyy	佯	佣	伢	伃
xbb	缨
xbc	绝不能
xbd	纷
xbf	缴
xbh	鬯
xbj	绵
xbk	隍
xbl	少不了
xbm	眢
xbn	鸳
xcc	缀	陲
xcf	缛
xcg	陉
xcj	绎
xck	编辑器	绐
xcl	编辑部
xcq	雀
xcx	辔
xdb	顷
xdc	郄	绂
xde	缭	绔
xdg	隋	隳
xdj	缎	欷	郗
xdk	继电器	绍
xdl	缅
xdr	陌
xdt	纫
xdx	绑	尜
xeb	彭
xec	纭	陬
xee	阮
xej	绊
xel	幼儿园
xen	绥
xep	绶
xes	隧
xeu	综合症
xew	多元化
xex	绨
xfb	陵	绫
xfc	尘
xfd	多方面
xff	绯	绋
xfh	陡
xfo	纣
xfr	绪
xfw	甄
xfx	鄄
xgb	绩
xgd	绒
xgg	小孩子	绀	绠
xgk	缂
xgl	缠
xgw	绕	隗
xgx	限
xhb	毖
xhc	西餐厅	陂
xhd	毙
xhf	防火墙
xhg	陔
xhh	纠	陟	骘
xhk	阽
xhm	编
xhn	绣
xho	隐私权
xhr	比利时	纳税人	绰
xhv	组委会
xia	象
xif	纡
xii	经济学	经济法
xil	缰
xim	绡	彝	绱
xin	陋
xio	西游记
xiv	小学生
xix	习	彘
xjc	绌
xjj	阱	缣
xjo	纨
xjs	陕
xjt	缆
xjy	刈
xkb	陨
xkd	绳
xke	缉
xki	心理学
xkk	缲
xkm	绢
xko	熹
xky	西班牙
xlg	缳
xli	隈
xlk	小商品	陪	嘉
xll	外交部	陇
xlo	心里话	外国语
xlp	缔
xlr	外国人	障
xlx	缌	缧
xmd	小朋友
xmf	绸
xmm	绷
xmr	多数人
xms	粟
xmu	心脏病
xmx	纲	缈
xng	小女孩
xnh	缗
xnm	刹那间
xnn	小姑娘
xnw	多媒体
xol	红楼梦
xom	缃
xon	多样性
xos	统计局
xov	阿根廷
xow	多样化
xox	畿
xoy	幺
xph	陀
xpi	阿富汗	绽	夤
xpn	绾
xpq	缤
xps	综
xpy	西安市
xqa	纸
xqf	陶
xqj	陷
xql	经销商
xqq	阡
xqr	绚
xqs	比基尼
xqv	隐	绉
xqx	纤
xqz	阻
xrc	阪
xrf	坠	陧
xrl	缦
xrm	缊
xrr	外星人
xrs	覃	陴
xrx	隰	绲
xsc	鼓	蠡
xsg	瓢
xsh	陈水扁	缜
xsj	际	刹	剽
xsk	随身听	缬
xsn	续
xsp	红十字	票
xss	绅
xst	缇	彖
xsy	弑
xta	绛
xte	缵	绗
xtf	缝
xti	隆
xtk	络
xtp	绺
xts	绦
xtt	覆
xty	纥
xub	绻	缢	隘
xur	缯
xvc	小灵通
xve	绘
xvg	维生素
xvh	纶
xvj	阶
xvk	小提琴
xvl	劣	缁	缫
xvn	缒
xvp	纪录片
xvw	阿拉伯	飨
xvx	乡
xvy	除
xvz	阼
xwb	缡
xwg	小伙子	缄	飧
xwi	缏
xwl	杀伤力
xwn	缑
xwq	纪念馆
xwr	纪念日
xww	阢
xxa	羿
xxc	戳	翟
xxf	终结者
xxh	陛	纰
xxi	鸶
xxk	纺织品
xxl	组织部	翼	翌
xxm	缪
xxo	西红柿
xxp	小组赛
xxq	外经贸
xxr	经纪人	隙
xxs	缥
xxv	纱	戮	鹨
xxx	陕西省	红外线
xxy	翠	爻
xym	缟
xyr	缙
xyu	缮
xyv	毕业生
yam	霰
yan	央
yaq	弃
yar	醋
yav	醛
ybg	高分子
ybu	用不着
ych	霍
yck	鲐
ycl	雳
yco	醮
ycv	鲢
ycy	零售业
ydm	頔
ydo	鱿
yea	哀
yeb	贰
yec	酝
yef	酹
yeg	凿
yel	霾
yem	裔
yev	亚运会	夜总会
yey	曳
yff	鲱	鲑
yfg	酵
yfo	酎
ygg	高跟鞋	酤	酐
ygh	酣
ygj	孰	塾
ygm	霸	醐	鲭
ygn	鹑
ygt	敦	憝
ygv	醣
ygx	享	郭
yhk	鲇
yhs	稣
yhv	高科技
yhx	用户名
yie	霪
yii	霈
yim	霄	酾
yir	高清晰
yis	邮政局
yjb	鲫
yjd	酊	颃
yje	裒
yka	襄	瓤
yke	鳄
ykk	酲
ykx	郡
ylf	鲤
ylh	亨
ylk	禀	醅
yll	霖
yln	霎
ylo	裹	烹
ylw	零部件
ylx	鲛	鳃
yma	盎
ymg	酮
ymv	醚
ymx	鳞
ync	高性能
yni	鸦	鸯
yoa	弈
yod	奕
yog	酿
yoh	霭
you	酉
ypb	卞
yph	酡
ypk	膏
ypm	毫
ypp	霹
ypv	亳
yqf	高尔夫
yqg	鳢
yqh	醺
yqs	迪斯尼
yra	愚人节
yre	衰
yrg	戬
yrl	鳗
yrr	卒	鲳
yrx	鲲
yte	酰
ytk	业务员	酪
ytm	霉	酶
ytp	预选赛
yuk	善	鄯
yuo	禺
yuy	禹
yvd	迪
yve	亵
yvf	鲟
yvm	矛
yvs	霆
yvw	矜
yvy	严
ywf	鲋
ywj	霁
ywk	褒
yws	恶作剧
yxb	酗
yxd	鹫
yxe	恶
yxj	京
yxk	酩
yxo	玄	率	畜
yxs	鳔
yxt	忒
yxv	雍	壅	饔
yxy	豫
yyu	鳝
yyv	袤
yyw	零配件
yyx	鲸
yzv	高中生
zaw	中英文
zeo	中关村
zew	自动化
zex	自尊心
zha	中秋节
zho	自以为
zhx	中科院
zia	自治区
zib	遗
zim	艄
zin	遣
zis	自来水
ziv	中学生
ziz	越来越
zjc	磐	槃
zjk	舸
zjy	中山市
zlx	中国队
zpo	自定义
zql	自然界
zsi	超声波
ztc	自行车
ztx	贵州省
zvf	艇
zwp	中文版
zwx	自信心
zxi	中小学
zxk	中小型
zyo	中高档
aaxk	匿名
abaf	芬芳
abay	芭蕾
abcm	节能
abdg	共存
abdt	节奏
abga	共度
abhk	节点	共和
abjv	共进
abkn	共鸣
ablc	共产
abmg	共同
abmu	节目
abok	共识
abos	共计
abrg	节后
abri	节日
absu	节水
abtd	共舞
abtj	节制
abue	芬兰
abum	节前
abuo	共有
abvb	节拍	共创
abvp	共建
abwn	节假
abxc	恭维
abxk	恭喜
abxq	节约
abxv	节省
abyg	共享
abyo	共用
acaw	莲花
adbu	若不
adcm	若能
adga	若干
adhu	惹火
adid	若无
admn	切断
adnn	切忌
adon	切记
adpf	切割
adpn	葬礼
adpu	切实
adqr	切勿
adse	切身
adsi	若是
aduo	若有
advq	切换
advy	切入
adxn	若要
aeel	菜单
aeni	菜鸟
aeoe	菜谱
aexu	菜肴
aeyn	匹配
afap	芙蓉
afbu	获赠
afec	获取
afhj	获利
afhq	著称
afhr	芳香
afll	莆田
afmv	获胜
aftr	获得
afub	获益
afuc	获准
afux	获奖
afvm	获悉
afwv	著作
afxi	芳心
afxk	著名
agag	苦苦
agah	葫芦
agan	蘑菇
agcc	苦难
agid	苦涩
agmx	苦闷
agnw	苦恼
agtv	苦笑
agxi	苦心
ahgg	燕子
ahxp	萎缩
aiah	茉莉
aiai	茫茫
aial	菠萝
aiaw	薄荷
aicf	落到
aidf	落在
aifl	落地
aigu	薄弱
aihu	落户
aiig	芜湖
aiim	落泪
aiip	落下
aiiu	荡漾
aiks	落叶
aild	范畴
ailw	范围
aimj	落幕
aimm	薄膜
aimx	落网
ainf	莱特
aipg	落空	落定
aipm	落寞
aipu	落实
aiqu	茫然
airg	落后
airi	落日
aivy	落入
aiwd	范例
aiwn	落成
aiww	落伍
ajhj	苛刻
ajlt	蓝图
ajqb	蓝色
ajti	蓝天
ajya	蓝牙
akjj	荆棘
aktv	荆州
alax	菩萨
albo	萝卜
aldh	世界大战
alee	苏联
aloo	苗木
alos	荔枝
alsu	薪水
alts	苗条
altv	苏州
aluq	薪资
alvs	菩提
alyr	苏醒
alyt	薪酬
amai	散落
amdj	散布
amfc	散发	散去
amhh	散步
amle	散了
amvo	散热
amwe	散文
anae	蔬菜
anda	巨大
andf	藏在
anfc	蒸发
anft	藏族
aniq	蒸汽
ankj	巨型
anlv	世界
anmr	世间
anps	世家
anpt	巨额
anqd	世贸
anqy	巨蟹
anre	世人	巨人
anrv	巨星
ansa	世上
anse	藏身
ansi	世事	巨石
ansu	藏书
anud	巨头
anuq	巨资
anwb	世俗
anwy	世代
anxn	世纪
aogl	芝麻
apaf	荣获
apap	蒙蒙
apec	劳动
apfe	荣幸
apgo	劳工
apgu	蒙古
aphj	营利
apii	荣誉
apiw	荣耀	荧光
aplo	苹果
aplx	劳累
apoo	营救
apqi	营销
apse	荧屏
aptk	营造
aptl	劳务
apuy	营养
apwk	劳保
apxg	萦绕
apye	营业
aqaq	葡萄
aqaw	菊花
aqce	警车
aqfa	警方
aqga	警戒
aqip	警觉
aqlr	敬意
aqnr	警惕
aqog	敬请
aqpn	警官
aqpw	警察
aqqz	警钟
aqsi	董事	警示
aqtk	警告
aqvb	警报
aqwm	敬佩
aqye	敬业
arar	草草
arat	草莓
arax	草药
aray	萌芽
arcb	草原
arfl	草地
arfp	草坪
arpn	草案
arri	昔日
arvh	蔓延
asaj	蔚蓝
asat	蔷薇
asax	医药
ashu	医科
asic	医治
asip	医学
asje	萧山
asji	医师
astl	医务
asul	医疗
asvg	医生
asvh	医护
aswk	医保
asxp	医院
asyo	医用
atai	蓬莱
atif	遨游
atsp	蓬勃
atyw	熬夜
avay	荟萃
avba	苍白
avck	苍蝇
avks	茶叶
avqp	茶馆
avti	苍天
awar	花草
awaw	荷花	葵花
awek	花瓶
awer	花儿
awfb	花费
awgf	荒废
awgh	花店
awgv	荒唐
awhg	花季
awhr	花香
awjo	花朵
awjt	莅临
awka	花开
awld	花瓣
awle	花园	花了
awlf	荒野
awlv	花边
awnk	花絮
awoo	花木
awox	荒谬
awoy	花样
awqg	花钱
awrr	花丛
awsa	花卉
awue	荷兰
awuy	荒凉
awvg	花生
awxi	花心
awxk	茂名
awxw	花纹
axan	蕴藏
axao	东芝
axap	东莞	东营
axax	东欧	东东
axbd	区分
axee	欧元
axfa	东方
axfg	区域
axfw	东城
axgh	药店
axhf	药房
axhh	东北
axhn	区委
axig	东湖
axip	药学
axit	欧洲	东海
axiu	艾滋
axje	东山
axkg	区号
axkk	药品
axkl	区别
axlk	东部
axlv	东边
axme	东门
axmr	区间
axmx	东风
axne	区内
axnq	药物
axof	药材
axpi	芯片
axqc	区县
axrm	东盟	欧盟
axsm	东南
axsu	药水
axud	欧美
axva	东升
axvj	殴打
axwj	药剂
axwn	蕴含
axxi	东西
axxr	欧阳
axya	东亚	欧亚
axye	药业
axyg	欧式
axyo	药用
axyx	东京
aybs	黄泉
aycy	英勇
aydb	黄页
aydc	英雄
ayff	黄土
ayfo	英寸
ayfv	英才
aygu	黄瓜
ayic	英汉
ayif	黄浦
ayij	黄河
ayje	黄山
aykk	艺品
aylk	英国
ayoo	艺术
ayow	英语
ayqa	黄昏
ayqb	黄色
ayql	英镑
ayrm	英明
aysi	黄石
ayvk	黄金
ayvl	蓄势
aywc	英俊
aywe	英文
aywv	英伦
ayxx	蕾丝
ayzd	英超
azvo	匮乏
baae	白菜
baec	白云
bafa	八方
bafb	白费
bafc	白发
baff	八卦
baga	八戒
bahq	巴黎
baii	八一
baiy	白酒
bako	白玉
bama	白马
bamm	八月
baoj	白皙
bapg	八字
bapk	白宫
baqb	白色
baqg	白银
bari	白日
basi	巴士	八十
bati	白天
baus	白痴
bavk	白金
bawc	白领
bawn	八成
baxi	巴西
baxq	白纸
baye	白衣
bayv	白雪
bber	婴儿
bbmb	凹凸
bcab	公共
bcbd	公分
bcce	公车
bcdj	公布
bcee	公元
bcet	公关
bcgg	公子
bcgt	公路
bchu	账户
bcib	公测
bcih	公正
bcji	公斤
bcka	公开
bckg	账号
bcle	公园	公了
bclf	公里
bclx	公交
bcng	公司
bcnh	公民
bcni	公牛
bcoi	公证
bcok	公主
bcor	公认
bcpf	公害	公社
bcpi	公平
bcpn	公安
bcpy	公寓
bcqu	公然
bcsi	公示
bctk	公告
bctl	公务
bcub	公益
bcus	公道
bcvb	公报
bcve	公会
bcvr	公众
bcwe	公文
bcwg	公仔
bcxd	公顷
bcxq	公约
bcyg	公式
bcyo	公用
bdam	分散
bdax	分区
bdca	分厂
bddb	分页
bddj	分布	分裂	颁布
bdfc	颁发	分发
bdgg	分子
bdgh	分店
bdgo	分工
bdhs	分歧
bdib	分泌
bdiy	分流
bdka	分开
bdkl	分别
bdld	分辨	分辩
bdlh	分站
bdlk	分部
bdlo	贫困
bdmd	分类
bdmn	分数
bdnm	分娩
bdoj	分析	分机
bdol	分为	分校
bdon	分之
bdpf	分割
bdpl	贫穷
bdqg	分钱
bdqi	分销
bdqm	分期
bdqy	分解
bdqz	分钟
bdri	分量
bdrm	分明
bdry	盆景
bdsc	分支
bdsn	分局
bdso	分手
bdte	分行
bdtp	分管
bdux	颁奖	翱翔
bdve	分会
bdvm	贫血
bdvr	分担
bdwb	分离
bdwn	分成
bdwq	分化
bdxg	分隔	分红
bdxi	分心
bdxj	分级
bdxp	分外
bdxq	分组
bdyg	分享
bdyn	分配
beqx	贝尔
besp	贝壳
bffn	赌场
bfhe	财税
bfic	财源
bfih	财政
bfio	赌注
bflc	财产
bfli	财力
bfnq	财物
bfog	邀请
bfpg	财富
bfps	财神
bfsf	赌博
bftl	财务
bfve	财会
bfxc	财经
bhad	贴切
bhdf	贴在
bhjv	贴近
bhlt	贴图
bhse	贴身
bhsi	贴士
bhxi	贴心
bhxq	贴纸
bied	必须
biib	卫浴
bimv	必胜
bios	必读
bipg	必定
bipj	必究
bipm	卫视
biqu	必然
birm	卫冕
birv	卫星
bisi	卫士
bitl	必备
biuo	必有
biux	必将
bivg	卫生
biwh	必修
bixn	必要
bixs	必杀
biyd	必需
biyu	赋予
bjcf	赚到
bjec	赚取
bjqg	赚钱
bjuo	则有
bjve	则会
bjxn	则要
bkbj	否则
bklp	皇帝
bkor	否认
bkpe	皇冠
bkpg	否定
bkpk	皇宫
bkps	皇家
bkrg	皇后
bkun	否决
blle	赔了
blwi	赔偿
bqhf	购房
bqls	购置
bqnq	购物
bqnu	购买
bqqi	购销
bqsu	购书
brsn	贩卖
bsbi	不知不觉
bssu	泉水
bstv	泉州
btlj	弊端
buaf	不菲
bubc	不公
bubd	不分
bubi	不必
bubt	贿赂	不败
bucb	不顾	不愿
bucc	不难
bucf	不对	不到
bucm	不能
buda	不大
budf	不在
budh	不死
budt	不忍
buee	不远
buek	不合
buel	不单
buen	不妥
buep	不受
buet	赠送
bufe	不幸
bufo	不过
bufq	不堪
buga	不甘	不干
bugi	不应
buhj	不利
buhk	不和
buhm	不肯
buhn	不透
buhz	不止
buia	不满
buid	不无
buif	不法
buih	不灭
buii	不一
buin	不与
buip	不觉
buir	不再
buiv	不当
buiw	不光
bujh	不顺
buji	不及
bujj	不出
bujk	不可
bujo	不凡
bujv	不进
bukb	不只
bukh	不足
bukj	不听
bukk	赠品
bukl	不理
bulc	不变
bule	不了
bulg	不羁
buli	不力
bulk	不回
buls	不禁
bumb	不服
bumg	不同
bumi	不免
bumk	不问
bumn	不断
bumq	不见
bumu	不料
bumv	不胜
buna	不懂	不惜
bunb	不怕
bunc	不怪
bune	不敢
bunf	不妨
bung	不好	不愧
bunk	不如
bunn	不已	不快
bunq	不懈
buns	不慎
buog	不良	不朽
buoh	不该
buol	不为
buom	不想
buoo	不求
buos	不计	不让
buov	不论	不许
buoy	不详
bupi	不平
bupn	不安
bupq	不宜
bupv	不容
buqa	不错
buqb	不负
buqk	不够	不适	不敌
buqu	不然
buqv	不争
buqy	不久	不解
burf	不时
burm	不明
burq	不易
busi	不是	不屑
busk	不知
busx	不息
busy	不尽
bute	不行
butf	不等
butm	不算
butp	不管
butr	不得
butw	不符
buuc	不准
buur	不曾
buve	不会
buvf	不失
buvh	不灵
buvo	不乏
buvy	不入
buwc	不仅
buwf	不佳
buwg	不便	不做
buwj	不齐
buwn	不成	不含
buwo	不住	不休
buwr	不但
buws	不值
buwx	不像	不忘
buwy	不停
buxc	不经
buxg	不限
buxh	不比
buxi	不象
buxq	不绝
buxv	不少
buxx	不多
buyd	不需
buym	不育
buyn	不配
buyo	不用
buyu	不善	不予
buzn	不起
bvad	迫切
bvcb	还原
bvcm	还能
bvgi	还应
bvij	还没
bvng	还好
bvog	还请
bvsi	还是
bvtm	还算
bvuo	还有
bvux	还将
bvwe	还未
bvwl	迫使
bvwm	欲望
bvxe	还给
bvxn	还要
bvyd	还需
bvyo	还用
bxbx	爷爷	爸爸
bxdm	不约而同
bxgg	父子
bxls	父亲
bxmu	父母
caca	厂长
cacg	长虹
cada	长大
cadf	长寿
cadr	长春
cadv	长达
caee	长远
cafc	长发	长辈
cafw	长城
caga	长度
cago	长廊
cahc	蜡烛
cahf	厂房
caig	长江
caij	长河
caix	长沙
cajj	长出
cakh	长足
calm	厂商
calx	长效
caom	长相
capn	长安	长官
caps	厂家
caqm	长期
caqy	长久
casg	长短
cata	长年
cath	长篇
cati	长征
catm	蜡笔
catp	长处
catr	长得
cavy	长途
cawn	长成	长假
cbaf	原著
cbbj	原则
cbds	原本
cbfl	原地
cbgg	原子
cbhx	顾虑
cbim	原来
cbiy	原油
cbji	顾及
cbkj	原型
cbkl	原理
cbkw	原味
cbld	原因
cblf	原野
cblr	愿意
cbmk	顾问
cbmu	原料
cbnc	原始
cbnn	顾忌
cboy	原谅
cbpg	原定
cbpr	原版
cbps	原神
cbpt	顾客
cbrn	厕所
cbry	愿景
cbsi	原是
cbsn	原声
cbte	原先
cbuo	原有
cbus	原装
cbvb	原创
cbwe	原文
cbwm	愿望
cbwn	原件
cbwq	愿你
cbwv	原价
cbxk	原名
ccai	轻薄
ccbu	又不
cccc	轻轻	双双
ccck	双唇
ccdl	双面
ccec	轰动
ccek	桑拿
ccep	难受
ccet	难关
ccfa	双方
ccfo	难过
ccfq	难堪
ccga	难度
ccgg	轻巧
ccgo	轻工
cchk	难点
ccho	难以
cchv	轰炸
ccii	又一
ccjb	双击
cckh	又叫
cckj	轻型
cckt	难吃
cclo	双龙
ccmf	双脚
ccmg	双腿	双眼
ccmi	难免
ccmk	又问
ccmu	双目
ccnb	又怕
ccnc	难怪
ccnn	轻快	双飞
ccnv	轻盈
ccob	轻松
ccoe	又说
ccol	难为	又为
ccom	又想
ccow	双语
ccpm	双臂	轻视
ccql	双重	轻重
ccre	双人
ccrm	难看
ccrq	轻易
ccsd	难题
ccse	双层
ccsn	轻声
ccso	双手
cctg	又很
cctj	轻微
cctr	难得
ccus	难道
ccux	又将
ccve	又会
ccvm	双向
ccwg	轻便
ccwk	双赢
ccwl	双倍
ccwx	难忘
ccxk	又名
ccxn	又要
ccyv	轻柔
cczv	难逃
cdcm	参观
cdfg	参考
cdin	参与
cdlk	参加
cdme	厦门	参阅
cdmj	参股
cdmn	参数
cdmq	参见
cdog	参谋
cdpb	参赛
cdrd	参照
cdsa	参展
cecl	车辆
ceco	车厢
cecv	车轮
cedc	车载
ceet	输送
cegc	车库
cegg	车子
cego	车床
cehk	车程
cejj	输出
cekj	车型
celc	蜕变
cele	输了
celf	车里
celh	车站
ceme	车门
cemr	车间
cemv	车迷
ceom	车模
ceov	允许
cepk	车祸
cepv	车窗
cesa	车上
cese	车身
cesv	车速
cete	车行
cevy	输入
cexe	输给
cexr	车队
cexs	车票
ceyj	车市
cfaq	致敬
cfba	对白
cfbv	压迫
cfcf	转到
cfcg	对劲
cfdc	转载
cfdh	致死
cfdi	致电
cfdl	对面
cfdm	转而
cfds	对本
cfdv	到达
cfec	转动
cfee	对联
cfek	致命
cfep	至爱
cfey	至尊
cffa	对方
cffc	转发
cffl	圣地
cffn	到场
cffo	到过
cffv	蚌埠
cfgi	对应
cfgq	到底
cfhh	至此	对此
cfhk	对战
cfhq	对称
cfhx	转移
cfif	对于	至于
cfim	到来
cfis	圣洁
cfjf	对峙
cfjh	转帖
cfkj	转型
cfkm	对吗
cfkn	到哪
cflc	转变
cfle	对了	到了
cflg	转弯
cfli	压力	致力	对立
cfmg	转眼
cfmu	辅料
cfof	到访
cfoj	转机	至极
cfol	转为
cfoq	对话
cfos	转让
cfov	圣诞
cfpg	致富
cfps	到家
cfqi	对其
cfqk	致辞
cfql	辅助
cfqm	到期
cfrd	对照
cfre	圣人
cfrf	到时
cfsa	至上
cfse	转身
cfsf	辅导
cfso	对手	到手
cfsv	转速
cftf	对待
cftj	对策	压制
cftp	到处
cfuc	对准
cfud	转头
cfun	对决
cfve	到会	转会
cfvj	转折
cfvl	对接	转接
cfvm	转向
cfvq	转换	压抑
cfvv	转播
cfvy	对抗	转入
cfwc	压倒
cfwf	对付
cfwl	致使	到位
cfwn	至今
cfwq	转化	到货	对华
cfxc	圣经	对阵
cfxh	对比
cfxi	对象
cfxp	对外	压缩
cfxv	至少
cgag	艰苦
cgan	艰巨
cgca	蝴蝶
cgcc	艰难
cgcf	轩辕
cgcv	蜻蜓
cghb	厨具
cghf	厨房
cghr	劲爆
cgji	厨师
cgko	虹口
cglk	颈部
cgls	艰辛
cgov	虹桥
cgqu	戏曲
cgsf	辐射
cgsg	戏剧
chcg	蝙蝠
cicv	齿轮
cjbu	暂不
cjca	厅长
cjid	暂无
cjle	删了
cjqi	暂且
cjrf	暂时
cjte	暂行
cjus	轨道
cjvh	删掉
cjwe	暂未
cjwy	暂停
cjxv	删除
cjyo	轨迹
ckfc	台独
ckhh	台北
ckhj	台灯
ckil	台湾
ckip	台下
ckit	台海
ckje	台山
ckjj	售出
ckko	台球
cklm	台商
ckmx	台风
ckni	蜗牛
ckom	售楼
ckon	台词
ckow	台语
ckrg	售后
cksa	台上
cksm	台南
cktv	台州
ckum	台前	售前
ckvj	台币
ckwv	售价
ckxs	售票
ckxv	台阶
ckyg	台式
ckzo	台中
clca	较长
clco	蟑螂
clft	螺旋
clgk	较强
clhk	历程
clim	历来
clng	较好
clnn	较快
cloe	劝说
clol	较为
cloo	厘米
clqy	螃蟹
clrf	历时
clri	较量
clrs	较早
clsi	历史
clsy	历届
clta	历年
clug	较差
clwq	较低
clwy	历代
clxc	历经
clxe	历险
clxi	较小
clxv	较少
clxw	螺纹
clxx	螺丝	较多
clym	较高
cmbk	能否
cmco	蚂蚁
cmec	能动
cmfa	熊猫
cmga	能干
cmgl	观摩
cmhk	观点
cmib	观测
cmic	能源
cmik	观赏
cmiw	观光
cmli	能力
cmlr	观音
cmoe	能说
cmol	能为
cmpw	观察
cmqk	能够
cmri	能量
cmrm	观看
cmvr	观众
cmwm	观望
cmwn	观念
cnnh	鸡蛋
coam	集散
coek	集合
cogg	虫子
cohk	焦点
cohx	焦虑
colf	集团
cooj	集训
coqb	集锦
coqv	焦急
couq	集资
cove	集会
cowd	集体
cown	集成
coxs	集结
coyj	集市
coyk	集群
cozo	集中
cpax	辖区
cplo	卧龙
cppc	卧室
cqgu	软弱
cqhd	厌烦
cqkh	欢呼
cqnn	欢快
cqqb	欢迎
cqqx	欢乐
cqsg	软硬
cqtv	欢笑
cqwd	软体
cqwn	软件
cqwu	厌倦
cqxk	欢喜
cqyx	厌恶
cqzm	软盘
crcf	遭到
crep	遭受	厚爱
crga	厚度
crql	厚重
crvk	曹操
cryv	遭遇
cscf	辗转
cscv	蜘蛛
ctpb	蜂蜜
cuoq	垂询
cush	垂直
cvce	轿车
cvcf	轮到
cvcv	连连
cvdc	连载
cvdf	连在
cvdp	连带
cvgy	轮廓
cvha	肆虐
cviy	轮流
cvkb	连环
cvlb	连贯
cvlk	轮回
cvlr	肆意
cvmc	轮胎
cvmg	连同
cvmv	连胜
cvnw	连忙
cvqi	连锁
cvvh	连个
cvvl	连接
cvxg	连线
cvxs	连续
cvyw	连夜
cwgg	蚊子
cwpf	厉害
cwsx	励志
cxlo	顾名思义
cyce	通车
cyco	蠕虫
cycy	通通
cydv	通达
cyet	通关
cyfo	通过
cyfr	勇者
cygt	通路
cyif	勇于
cyik	通常
cymx	通风
cyne	勇敢
cyns	轴承
cyon	通讯
cyoq	通话
cypi	通宵
cyqi	勇气
cysi	勇士
cysk	通知
cyte	通行
cytk	通告
cyto	通往
cyus	通道
cyvb	通报
cyvm	通向
cywb	通俗
cywq	通货
cywy	通信
cyxg	通红
cyxk	通缉
cyyo	通用
daas	大蒜
daba	大巴
dabi	大卫
dabx	大爷
dacd	大厦
dace	大臣
dacf	大致
dacj	大厅
dacm	大观
dacv	大连	大肆
dadb	大典
daei	刀剑
daej	大半
dafa	大方
dafl	大地
dafo	大专
dafr	大都
daft	大旗
dafu	大夫	大增
dagd	大庆
dagg	刀子
dagt	大路
dagu	大豆
dagv	大唐
dahb	刀具
dahh	大步
dahk	大战
dahu	大火	大户
dahx	大餐
daic	大汉
daif	大法	大于
daig	大清	大涨
daii	大举
daij	大河
daim	大漠
daip	大学
dait	大海
daiy	大洋
daje	大山
dajg	大幅
daji	大师
dajk	大哥
dakh	大叫
dakj	大型
dakk	大王
dakl	大理
dakm	大骂
dakq	大哭
dakw	大喊
dale	大四
dali	大力
dalk	大国
dalp	大帝
dalr	大意
damd	大类
dame	大门
damg	大腿	大同	大眼
damm	大鹏
damp	大腕
damr	大胆
damv	大胜
damw	大脑
damx	大风
damy	大闹
danc	大怒
dang	大好
danq	大姐
daoc	大树
daog	大概
daol	大为
daom	大楼
daoo	大米
daoq	大话
daos	大计
daov	大桥
dapb	大赛
dapc	大军
dapg	大字
dapi	大片
dapn	大案	大礼
daps	大家
daqi	大气
dari	大量
darm	大明
dasa	大碟	大展
dasi	大事
dasn	大局	大声
data	大年
date	大选
datf	大街	歹徒
datv	大笑
daud	大头
daui	大病
dauo	大有
daus	大道
daux	大将	大奖
davb	大把
dave	大会
davk	大全
davl	大势
davr	大众
davx	大批
dawd	大体
dawh	大伙
dawj	大侠
dawl	大使
dawv	大作
daxg	大红
daxi	大小	大象
daxj	大陆
daxk	大喜	大名
daxm	大纲
daxp	大院
daxq	大约
daxr	大队	大阪
daxx	大多
daye	大衣	大业
dayl	大亨
dayu	大雨
dayv	大雪
dazm	大盘
dbai	典范
dban	典藏
dbdl	页面
dbkj	典型
dbmn	页数
dbpn	典礼
dbsm	页码
dbuq	页次
dbyc	典雅
dccf	截至
dccr	雄厚
dchf	套房
dchx	套餐
dchz	截止
dclt	截图
dcmx	雄风
dcng	友好	友情
dcop	友谊
dcre	友人
dcsy	殆尽
dcus	套装
dcvy	载入
dcwd	载体
dcwn	套件
dcww	雄伟
dcxi	雄心
dcyu	友善
deda	夸大
degc	夸张
desi	的士
desq	的确
deux	夸奖
dfan	在世
dfec	夺取
dfek	寿命	在职
dffn	在场
dfhh	在此
dfhu	在乎
dfif	在于
dfii	死去活来
dfip	在下	在学
dfjb	在即
dfkj	在听
dfkn	在哪
dflr	在意
dfmu	夺目
dfne	在内
dfoe	在说
dfol	在校
dfos	在读
dfpe	夺冠
dfps	在家
dfqi	在其
dfsa	在上
dftr	夺得
dfum	在前
dfwm	奢望
dfwq	奢华
dfwx	奢侈
dfxe	在给
dfxg	在线
dfxp	在外
dfyo	在用
dfyx	在京
dgdf	存在
dgdk	左右
dgdt	残忍
dgec	存取
dgfn	残缺
dgfs	存款
dgft	存放
dgiq	存活
dglv	左边
dgoi	存档
dgqd	残留
dgso	左手
dgus	残疾
dgvy	存入
dgwb	左侧
dgwo	存储
dgwq	存货
dgyt	残酷
dhfc	死去
dhfr	死者
dhif	死于
dhik	死党
dhiq	死活
dhkj	死刑
dhle	死了
dhoj	死机
dhps	死神
dhqb	灰色
dhre	死人
dhrg	死后
dhrl	灰暗
dhvh	死掉
dhwa	死亡
dhxf	灰尘
dhxi	死心
dica	电厂
dice	电车
dicf	电压
dick	电台
dicm	电能
dida	电大
diec	电动
digg	电子
digo	电工
digt	电路
diic	电源
diil	电池
diiy	电流
dike	电玩
dikq	电器
dilh	电站
dili	电力
dimw	电脑
dimx	电网
dioe	电梯
dioj	电机
dion	电讯
dioq	电话
dipm	电视
dipv	电容
diqg	电镀
diqi	电气
diqy	电解
diry	电影
disu	电磁
ditm	电筒
divo	电热
diwy	电信
dixg	电线
dixj	电缆
dixq	电阻
diyx	电邮
djai	段落
djce	列车
djcm	奇观
djdv	尴尬
djge	列表
djhu	烈火
djia	布满
djii	列举
djjj	列出
djls	布置
djme	奇闻
djmu	布料
djnc	奇怪
djnf	奇特
djnx	奇妙
djoj	布朗
djol	列为
djqb	奇兵
djri	烈日
djsa	奇异
djsi	烈士
djsm	奉献
djsn	布局
djte	奉行
djvy	列入
djwj	奇侠
djws	布什
djxg	布线
djxo	奇幻
djxx	奇缘
djyo	奇迹
djyv	奇遇
dkco	召集
dkka	召开
dkkq	召唤
dklk	召回
dklv	右边
dkqv	右键
dksa	右上
dkso	右手
dkwb	右侧
dlan	面世
dlcf	面对
dleb	面貌
dlgg	面子
dlgn	面孔
dlhb	面具
dlhk	面积	奋战
dlid	面无
dljt	面临
dljv	奋进
dlli	奋力
dllk	面部
dlmb	面粉
dlmm	面膜
dlmu	面目	面料
dloo	面议
dlor	面板
dloy	面试
dlpv	面容
dlqb	面色
dlqs	面包
dlqx	戴尔
dlts	面条
dlum	面前
dlus	奋斗
dlvm	面向
dlxx	面纱
dmbu	而不
dmcc	而又
dmcf	而至
dmdf	而在
dmdh	而死
dmey	夏普
dmfc	而去
dmfe	而非
dmfo	而过
dmgl	耐磨
dmhd	耐烦
dmhg	夏季
dmhu	耐火
dmim	而来
dmnn	而已
dmpg	而定
dmqi	而且
dmrg	而后
dmri	夏日
dmsi	而是
dmti	夏天
dmwn	而今	而成
dmxi	耐心
dmxn	而要
dmyk	而言
dmyo	耐用
dobu	太不
docb	太原
doda	太大
dodo	太太
doee	太远
dofl	栽培
dofo	太过
doga	态度
dogg	太子
doig	太湖
dojt	太监
dong	太好
donq	尤物
dooj	太极	太郎
dool	尤为
dopg	太空
dopi	太平
doqi	尤其
doqy	太久
dorm	太晚
dors	太早
doug	太差
douw	太冷
dovl	态势
doxr	太阳
doxx	太多
doym	太高
dozi	太贵
dpcf	带到
dpec	带动	牵动
dpgh	牵引
dpih	牵涉
dpim	带来
dplk	带回
dppa	带宽
dpso	牵手
dpud	带头	牵头
dpum	带着
dpuo	带有
dpvf	牵挂
dpwc	带领
dpxe	带给
dpzo	带走
drab	春节
draw	百花
drbd	百分
drdm	春夏
drdo	百态
drec	春运
dree	百元
drek	百合
drga	百度
drgk	百强
drhg	春季
drhh	春秋
drhu	百科
driw	春光
drlc	百变
drmx	春风
drnv	百姓
drps	百家
drqb	春色
drsi	百事
drsu	春水
drta	百年
drti	春天
drvh	百灵
drwa	百万
drwl	百倍
drwq	百货
drye	百业
dryu	春雨
drzj	百般
dsbd	本分
dscm	本能
dsff	本土
dsfl	本地
dsft	奔放
dsgg	本子
dsgj	本刊
dsgq	奔跑
dshu	本科
dsih	奔波
dsim	本来
dsje	泰山
dslh	本站
dslk	泰国	本国	本部
dsll	本田
dslr	本意
dsmd	本类
dsmf	本周
dsml	奔驰
dsmm	本月
dsmu	奔腾
dsnh	殖民
dsnv	本性
dsol	本校
dspn	泰安
dsqb	本色
dsqg	本钱
dsre	本人
dsrs	本质
dsse	本身
dssi	本事
dssy	本届
dstv	泰州
dsuq	本次
dsvb	本报
dsve	本会
dsvm	奔向
dswc	本领
dswe	本文
dswj	奈何
dsyj	本市
dszo	奔走
dtep	忍受
dtfr	忍者
dtwo	忍住
dtxi	忍心
dvap	殊荣
dvcf	达到
dvos	达标
dvwn	达成
dxnn	爽快
dxnw	帮忙
dxql	帮助
dxso	帮手
dyej	裁判
dykb	裁员
dyun	裁决
ebvs	爱不释手
ebwh	貌似
ecai	动荡
ecap	运营
ecce	运输
eccf	运转
ecco	聚集	云集	聚焦
ecdf	聚在
ecdo	动态
ecec	运动
ecek	聚合
eceo	云彩
ecet	运送
ecfb	运费
ecge	动弹
ecgm	动静
ecgo	动工
echk	运程
echx	聚餐
ecii	取消
ecij	运河
ecil	动画
ecir	动漫
ecjj	取出
eckb	动员
eckj	动听
ecli	动力
eclk	取回
eclo	云龙
ecmo	动脉
ecmv	取胜
ecng	动情
ecnq	动物
ecoi	取证
ecoj	动机
ecqi	运气
ecre	动人	取暖
ecry	取景
ecsm	云南
ecso	动手
ecte	运行
ectm	运算
ectr	取得
ecun	取决
ecve	动摇	聚会
ecvg	取舍
ecvm	动向	取向
ecwg	动感
ecwv	动作	运作
ecwy	取代
ecxi	动心
ecxk	取名
ecxl	取缔
ecyo	运用	动用
ecyt	云雾
edsk	须知
eeap	联营
eeax	远东
eecq	联欢
eecy	联通
eeda	远大
eedf	远在
eedx	联邦
eeee	远远
eeek	联合
eefa	远方
eefc	远去
eefh	元老
eegk	顽强
eegu	远古
eegx	元素
eehk	远程
eein	耿耿于怀
eeiy	远洋
eejv	远近
eelg	顽固
eemm	元月
eemx	联网
eeom	联想
eeop	联谊
eepb	联赛
eepc	联军
eepi	元宵
eeqi	元气	远销
eeri	元旦
eerm	聪明	联盟
eery	远景
eeso	联手
eete	远行
eeti	远征
eetp	远处
eevr	联众
eevv	联播
eevx	联系
eewb	远离
eewn	元件
eexk	联名
eext	联络
efee	遥远
efef	遥遥
efvp	遥控
eghf	乳房
egiy	乳液
egmb	乳腺
ehcf	耻辱
ehud	丫头
eiov	剑桥
eipt	剑客
ejfn	半场
ejhk	半点
ejkj	判刑
ejko	半球
ejmm	半月
ejmn	判断	半数
ejnj	半岛
ejpg	判定	半空
ejse	半身
ejta	半年
ejti	半天
ejtp	判处
ejun	判决
ejuv	叛逆
ejvg	半生
ejyw	半夜
ekab	总共
ekbd	总分
ekbj	总则
ekbq	并购
ekbu	并不
ekca	总厂
ekcf	拿到
ekcg	瓶颈
ekcm	职能
ekdg	并存
ekdj	并列
ekdy	总裁
ekec	命运
ekek	合并
ekfc	并发
ekfe	并非
ekgb	职责
ekgg	盒子	瓶子
ekgo	职工
ekhk	总和
ekhm	并肩
ekhq	职称
ekhu	合乎
ekia	总汇
ekid	并无
ekif	合法	并于
ekii	合一
ekij	并没
ekim	拿来
ekip	拿下
ekjj	拿出
ekjk	并可
ekjt	总监
ekkb	职员
ekkl	总理	合理
ekkm	兑现
ekkr	合唱
eklf	总署
eklh	总站
eklk	总部
ekmb	合肥
ekmg	合同
ekmn	总数
ekoc	职权
ekog	并请
ekoj	总机
ekol	并为
ekon	总之
ekos	合计	总计
ekot	合格
ekpt	总额
ekqi	并且
ekqk	合适
ekql	并重
ekri	总量
ekry	合影
eksd	命题
eksi	总是
eksn	总局
ekso	拿手
ekte	并行
ektl	职务
ektm	总算
ekuo	并有	总有
ekuq	合资
ekux	并将
ekve	总会
ekvk	合金
ekvp	并按
ekvq	兑换
ekwc	命令
ekwd	总体
ekwe	并未
ekwh	合伙
ekwl	职位
ekwn	合成
ekws	总值
ekwv	合作
ekxg	总线
ekxh	总编	总比
ekxk	命名
ekxn	总要
ekxq	合约
ekxs	总结
ekxy	总统
ekye	职业
ekyo	并用	并由
ekzo	命中
elai	单薄
elas	兽医
elce	单车
elee	单元
elel	单单
elfc	单独
elgd	单项
elii	单一
eljb	单击
eloj	单机
elom	单调
elon	单词
elqb	单色
elqf	爱因斯坦
elqu	单曲
elre	单人
else	单身
elsi	爵士
elvh	单个
elvm	单向
elwl	单位
elwv	单价
elxt	单纯
emek	愈合
emqm	逾期
ensl	妥协
envk	亏损
enyu	妥善
eobq	采购
eocg	彩虹
eoco	采集
eodi	彩电
eoec	采取	彩云
eoof	采访
eoqb	彩色
eoqi	彩印
eose	彩屏
eosg	采矿
eoun	彩妆
eowy	彩信
eoxn	采纳
eoxs	彩票
eoxv	彩绘
eoyo	采用
epag	受苦
epbu	受贿
epcf	受到
epdl	爱戴
epfo	受过
epkl	受理
epkt	爱吃
eple	受了
eplk	爱国
eplr	爱意
eplx	爱恋
epmh	受骗
epmx	爱慕
epna	爱惜
epng	爱情	爱好	爱恨
epok	耽误
epon	爱之
eppf	受害
epre	爱人
epsa	爱上
epub	受益
epud	爱美
epvh	爱护
epvk	受损
epwq	爱你
epwt	受伤
epxi	爱心
epxq	受阻
eqeq	聊聊
eqfw	聊城
eqti	聊天
equm	聊着
erfr	二者
ergg	儿子
erhk	二战
erhu	儿科
eriw	耳光
erjk	儿歌
erjo	耳朵
erkb	耳环
erll	儿童
erlv	耳边
ermm	二月
ernn	二奶
ernv	儿女
eroj	耳机
erom	二楼
erqm	二期
errf	儿时
ersi	二十
erso	二手
erxj	二级
esax	二十世纪
etab	关节
etad	关切
etaw	送花
etcf	送到
etdv	送达
etee	关联
etep	关爱
etfc	送去
ethe	关税
etif	关于
etim	送来
etio	关注
etjj	送出
etme	关门
etmf	关闭
etnb	关怀
etoj	关机
etql	郑重
etqv	关键
etrd	关照
ettv	郑州
etud	关头
etvh	关掉
etvx	关系
etwq	送货
etxe	送给
etxi	关心
etzo	送走
ewkj	聆听
exex	弟弟
exfu	递增
exgg	弟子
exke	弟兄
exlx	递交
exxe	递给
exyh	耶稣
eyaq	尊敬
eycy	普通
eyhm	普遍
eyji	普及
eyog	聘请
eyor	普查
eyox	遵义
eypf	遵守
eypg	奠定
eyqf	奠基
eyql	尊重
eytr	遵循
eyxp	普陀
eyyo	聘用
eyyv	尊严
eyyx	普京
eyzi	尊贵
facm	方能
fadl	方面
fafn	方块
fafv	方才
fahk	方程
faif	方法
fajk	方可
fake	方形
fakm	猫咪
falk	方圆
falt	方略
fapn	方案
faqs	方针
fare	猎人
faud	罐头	猎头
favm	方向
fawg	方便
fawl	方位
fayg	方式
fayk	方言
fazo	方舟
fbfm	犯规
fblf	犯罪
fbli	费力
fbnh	坏蛋
fbqa	犯错
fbre	坏人
fbsi	坏事
fbyo	费用
fcan	去世
fcay	发芽
fcba	独白
fcbf	发财
fcbu	却不
fccc	却又
fccf	独到	发到
fcck	发售
fcdf	却在
fcdh	去死
fcdi	发电
fcdj	发布
fcdv	发达
fcec	发动
fcet	发送
fcfo	去过
fcft	发放
fcge	发表
fcgg	辈子
fchb	独具
fchg	发烧
fchh	发愁
fchk	堆积	独占
fchu	发火
fcia	发泄
fcic	发源
fcim	发来
fcip	发觉
fciw	发光
fcjh	发帖
fcji	埃及
fcjj	发出
fckj	发型
fckm	发现
fcko	发呆
fcle	发了
fcli	独立
fclr	发音
fclu	却也
fcmk	发问
fcnf	独特
fcoe	却说
fcos	却让
fcph	却被
fcps	独家
fcrm	发明
fcsa	发展
fcsf	发射
fcsi	却是
fcta	去年
fcte	发行	独行
fctp	去处	独处
fcui	发病
fcum	发疯
fcuo	却有	独有
fcuq	独资
fcvb	独创
fcvf	劫持
fcvg	发生
fcvh	去掉
fcvj	发誓
fcvm	去向
fcvn	发扬
fcvo	发热
fcvp	发挥
fcvs	发掘
fcvu	发抖
fcwe	发文
fcwq	发货
fcwv	发作
fcwy	发信
fcxe	发给
fcxn	却要
fcxs	发票
fcxv	去除
fcyf	发酵
fcyg	独享
fcyk	发言
fcym	发育
fcyp	发亮
fczi	独自	发自
fczn	发起
fddo	犹太
fdnk	犹如
fdoj	契机
fdxq	契约
fdyx	犹豫
feck	丰台
fecr	丰厚
fedb	非典
fedg	幸存
feec	幸运
feen	幸亏
fehh	丰收
feia	丰满
feif	非法
feik	非常
feit	非洲
fejo	非凡
fell	丰田
femq	丰胸
feng	幸好
fepg	幸福	丰富
fetr	非得
fewn	丰盛
fexn	非要
ffdl	封面
fffl	土地
fffy	土壤
ffgu	土豆
ffgy	寺庙
ffmf	封闭
ffmg	慧眼
ffnr	猪肉
ffoo	土木
ffpf	堵塞
ffpp	替补
ffps	封神
ffqi	封锁	封印
ffse	替身
ffti	敷衍
ffus	封装
ffvp	封建
ffvq	替换
ffwy	替代
ffxs	封杀
fgbx	教父
fgcf	教辅
fgdj	猛烈
fgfl	猛地	狐狸
fgfn	考场
fggu	考古
fghk	教程	考点
fghn	教委
fghx	考虑
fgib	猜测
fgik	教堂
fgip	教学
fgjh	孝顺
fgji	教师
fgjl	考勤
fgkc	教唆
fgll	猛男
fgme	考验
fgof	教材
fgoh	考核
fgoi	考证
fgoj	教训
fgom	猜想
fgop	考评
fgoy	考试
fgpc	教室
fgpe	考完
fgpn	教案
fgpw	考察
fgqu	猛然
fgsa	考上
fgsf	教导
fgsk	考研	教研
fgsu	教书
fgtf	教徒
fgtl	教务
fgum	考前
fguy	教养
fgve	教授	教会
fgvg	考生
fgvr	狠抓
fgvy	考入
fgxi	狠心
fgxk	域名
fgxl	教练
fgym	教育
fhbc	老公
fhbx	老爷	老爸
fhda	老大
fhdc	老友
fhek	老总
fhfu	老夫
fhgg	老子
fhhj	老虎
fhih	老婆
fhjh	老鼠
fhji	老师
fhjk	老歌
fhke	老兄
fhnm	老妈
fhor	老板
fhpr	老牌
fhps	老家
fhpu	老实
fhre	老人
fhta	老年
fhti	老天
fhud	老头
fhux	老将
fhwq	老化
fhxp	老外
fhxv	老少	老乡
fjgg	狮子
fjpv	狭窄
fjxi	狭小
fkcq	狂欢
fkds	狂奔
fkih	狂潮
fklf	狂野
fkmx	狂风
fkom	狂想
fkqq	狂飙
fkre	狂人
fktf	逛街
fkvo	狂热
fkwn	狂妄
flad	埋葬
flan	埋藏
flax	地区
fldf	埋在
fldj	地段
fldl	地面
fldp	地带
flfa	地方
flfg	地域
flfh	地址
flfj	垃圾
flfl	境地
flfm	狡猾
flfo	地狱
flhe	地税
flhh	地步
flhj	地利
flhk	地点
flip	地下
flke	地形
flkl	地理
flko	地球
fllc	地产
fllf	地里
fllt	地图
fllv	境界
flmh	地毯
flne	境内
floj	培训
flok	地主
flor	地板
flqv	地铁
flrs	地质
flsa	地上
flsf	地砖
fltp	地处
flud	埋头
flus	地道
fluy	培养
flvl	地势
flwl	地位
flwq	埋伏
flxb	埋怨
flxk	地名
flxp	境外
flyc	地震
flym	培育
flzm	地盘
fmai	规范
fmbj	规则
fmgo	规划
fmhk	规程
fmlr	规章
fmom	规模
fmot	规格
fmpg	规定
fmpv	规避
fmsa	规矩
fmtv	规律
fndl	场面
fnek	场合
fnfl	场地
fnga	缺席
fnhk	缺点
fnko	缺口
fnqp	场馆
fnrn	场所
fnry	场景
fnvf	缺失
fnvo	缺乏
fnwq	缺货
fnxp	场外
fnxq	缺陷
fnxv	缺少
foab	过节
foaf	专著
foan	过世
foap	专营
foax	专区
fobd	过分
foca	专长
fock	专辑
foej	过半
foek	专职
foet	过关
fofb	狼狈
fofc	过去
fofn	专场
foga	过度
fogd	专项
fohh	过剩
fohj	专利
fohk	过程	专程
fohu	专科	过户
fohy	专稿
foif	过于
foig	过渡
foih	过滤
foii	专一
foij	过河
foim	过来
fokb	专员
fome	专门
fooa	专柜
foof	专访
fool	专为
foou	专栏
fopl	赤裸
fopn	专案
fops	专家
fopt	过客
foqa	过错
foqm	过期
foqu	赫然
fore	过人	专人
forf	过时
forg	过后
fori	过量
fors	过早
fosd	专题
fosg	过硬
fosn	专卖
fota	过年
fotm	过敏
foto	过往
fotr	过得
foud	过头
fouo	专有
foux	过瘾
fovf	过失
fovo	过热
foxg	专线
foxi	专心
foxx	过多
foye	专业
foym	过高
foyo	专用
foyw	过夜
fpfa	狩猎
fpfw	盐城
fqfj	坎坷
fqhq	堪称
fqim	艳丽
fqjb	狙击
fqjk	均可
fqol	均为
fqqu	均匀
fqtq	均衡
fquo	均有
fqxr	艳阳
fqyo	均由
fqyv	艳遇
frba	坦白
frbu	都不
frdf	都在
frfc	猖獗
frge	坦克
frow	坦诚
frqu	坦然
frtr	都得
fruo	都有
frve	都会
frxn	都要
fryj	都市
fryk	坦言
fryx	坦率
fsdl	墙面
fsgd	款项
fspf	墙壁
fspi	填写
fspp	填补
fsqy	墙角
fssa	墙上
fsvb	填报
fsvy	填入
fsxq	墙纸
fsye	填充
fsyg	款式
ftai	放荡
ftcf	旋转	放到
ftcv	放肆
ftda	放大
ftdf	放在
ftdi	放电
ftfo	放过
ftgo	施工
fthk	旅程
ftif	旅游
ftip	放下	放学	旗下
ftjj	放出
ftjk	旗帜
ftjv	放进
ftka	放开
ftlk	施加
ftls	放置
ftmg	放眼
ftmx	旋风
ftnn	放飞
ftnr	放慢
ftob	放松
ftpa	放宽
ftpq	旗袍
ftpt	旅客
ftqp	旅馆
ftry	放映
ftsa	施展
ftsf	放射
ftsn	放声
ftso	放手
ftsx	放屁
ftte	旅行	施行
fttv	旋律
ftvy	旅途	放入
ftwn	放假
ftwv	放任
ftxi	放心
ftxr	放纵
ftya	放弃
ftzm	旗舰
fuca	增长
fucf	增至
fuda	增大
fugg	夫子
fugk	增强
fuhh	增收
fuit	增添
fujg	增幅
fujv	增进
fulk	增加
funv	夫妇
fuoj	增设
fure	夫人
furi	增量
fuvn	夫妻
fuws	增值
fuxx	增多
fuym	增高
fvcm	才能
fvgg	才子
fvng	才好
fvnv	才女
fvuo	才有
fvve	才会
fvwq	才华
fwax	城区
fwfs	城墙
fwgg	猴子
fwhh	城北
fwlf	城里
fwmf	坟墓
fwne	城内
fwqs	城镇
fwtp	城管
fwvp	城建
fwwk	城堡
fwxi	城西
fwxp	城外
fwxv	城乡
fwyj	城市
fwzo	城中
fxcm	悲观
fxnc	悲惨
fxng	悲情
fxsg	悲剧
fxuc	悲痛
fxus	悲壮
fxwt	悲伤
fxxx	翡翠
fxye	悲哀
gacb	甘愿
gafo	度过
gagm	戒毒
gahk	干燥
gahl	戒烟
gaih	干涉
gaiq	干活
gakm	干吗
galk	干部
gamq	干脆
gasi	干事
gasu	甘肃
gaub	席卷
gauq	干净
gavd	干扰	遮掩
gavh	戒指	干掉
gawb	距离
gawn	度假
gawo	遮住
gaxg	干线
gaxi	甘心
gayd	干预
gbnc	责怪
gbsm	贡献
gbtl	责备
gbwc	责令
gbwv	责任
gbxh	责编
gcbh	张贴
gcda	张大
gcdg	库存
gcgv	踊跃
gcka	张开
gcli	张力
gcvn	弘扬	张扬
gcwm	张望
gddb	庆典
gdfe	庆幸
gdlk	跨国
gdmu	项目
gdpk	庆祝
gdqc	项链
gdzh	跨越
geba	表白
gebu	更不
geca	更长
gecm	更能
geda	更大
gedl	表面
gedo	表态
gedv	表达	应运而生
geee	更远
geek	革命
geel	表单
gegk	更强
gehb	更具
geih	更正
geip	表演
gejj	弹出
gekm	表现
gelk	更加
gelr	表彰
gels	更新	革新
gemb	克服
geng	表情	更好
genh	更改
genn	更快
genv	弹性
geol	更为
geoo	表述
geos	更让
geot	表格
germ	表明
gerv	克星
gesi	表示
geta	弹簧
getj	克制
geud	更美
geun	表决
geuo	更有
gevn	表扬
gevq	更换
gewq	更低
gexk	更名
gexn	更要
gext	克隆
gexx	更多
geyg	表露
geym	更高
gffh	废墟
gfgg	鞋子
gfhr	废旧
gfjr	鞋帽
gfle	庄园
gfmd	鞋类
gfnq	废物
gfoq	废话
gfya	废弃
gfye	鞋业
gfyv	庄严
ggek	巧合
ggel	孤单
gger	孤儿
ggex	子弟
ggfc	孤独
ggge	子弹
gggp	跟踪
gggs	践踏
gggx	子孙
ggjv	跟进
ggli	孤立
ggnv	子女
ggnx	巧妙
ggpk	子宫
ggps	孤寂
ggum	跟着	跟前
ggvv	跌跌撞撞
ggxu	跟随
ggyo	巧用
ghaq	引擎
ghca	店长
ghdl	店面
ghfc	引发
ghgg	孩子
ghhr	引爆
ghim	引来
ghje	庐山
ghjj	引出
ghjv	引进
ghlf	店里
ghne	店内
ghok	店主
ghqf	店铺
ghre	引人
ghsf	引导
ghuq	引资
ghvy	引入
ghwc	引领
ghyo	引用
ghzn	引起
gibf	应邀
gicf	应对
giey	应聘
giiv	应当
gilc	应变
gioh	应该
giol	应为
gioy	应试
giqv	应急
gisy	应届
gite	应答
giuo	应有
giwf	应付
giyo	应用	应由
giyt	应酬
gjdc	刊载
gjih	廉政
gjis	廉洁
gjki	恐吓
gjlg	巩固
gjlo	恐龙
gjna	恐慌
gjnb	恐怕
gjnd	恐怖
gjnh	恐惧
gjnq	刊物
gjwg	刊登
gjwv	廉价
gkbv	强迫
gkcg	强劲
gkda	强大
gkdj	强烈
gkfr	或者	强者
gkga	强度
gkgu	强弱
gkli	强力
gklk	强国
gkng	强奸
gknr	强悍
gkom	强调
gkoo	强求
gkov	或许
gkra	强暴
gkre	强人
gksg	强硬
gksi	或是
gkte	强行
gktj	强制
gkuq	强盗
gkus	强壮
gkvl	强势
gkwq	强化
glap	功劳
glbv	逼迫
glcc	磨难
glce	功臣
glcm	功能
glda	庞大
glds	副本
glek	副总
glfu	功夫
glgq	功底
glgu	魔鬼
glhd	麻烦
glhj	功利
glif	魔法
gljv	逼近
glkk	魔王
glld	麻辣
glli	功力	魔力
gllm	功耗
gllx	功效
glnv	魔女
glog	摩根
glol	功课
gloo	麻木	魔术
glqb	辜负
glqo	胡思乱想
glre	逼人
glsh	逼真
glul	麻痹
glux	麻将
glvk	磨损
glvp	摩擦
glvv	摩托
glwg	摩登
glxc	麻雀
glxo	魔幻
glyx	功率
glyy	麻醉
gmae	青菜
gman	青藏
gmar	青草
gmax	毒药
gmcf	青蛙
gmdi	静电
gmdo	静态
gmdr	青春
gmek	融合
gmgg	胡子
gmgm	静静
gmgx	毒素
gmhz	静止
gmid	青涩
gmie	融洽
gmit	青海
gmje	青山
gmkk	毒品
gmlo	青龙
gmlr	静音
gmmg	胡同
gmmi	青睐
gmmo	静脉
gmnj	青岛
gmnv	毒性	靓女
gmoe	胡说
gmpn	静安
gmqk	胡乱
gmqm	青铜
gmrd	靓照
gmta	青年
gmti	青天
gmuq	融资
gmvy	融入
gmwq	融化
gmyg	毒霸
gngg	孔子
gnxc	孔雀
goay	工艺
gobd	划分
gobu	胡说八道
goca	工厂
goel	床单
goff	廊坊
gofl	工地
gofn	工场
gofu	工夫
gogy	工序
gohb	工具
gohh	某些
gohk	工程
gohz	某种
golm	工商
golv	床边
goqd	工贸
gore	工人	某人
gosa	床上
gote	工行
goti	某天
gotm	划算
goud	床头
gouq	工资
gove	工会
govf	床垫
govh	某个
gowv	工作
goye	工业
gpje	鞍山
gpry	踪影
gpyo	踪迹
gqax	底蕴
gqce	跑车
gqcf	跑到
gqhh	跑步
gqip	底下
gqir	弥漫
gqlk	底部
gqpp	弥补
gqse	底层
gqus	跑道
gqwv	底价
gqxg	底线
gqzm	底盘
grji	巫师
grko	踢球
grod	座椅
groh	座谈
grwl	座位
gsgm	踏青
gsjv	踏进
gspu	踏实
gssa	踏上
gsvy	踏入
gtdj	路段
gtdl	路面
gtet	攻关
gtfo	路过
gtge	攻克	麦克
gtgg	路子
gthj	路灯
gthk	路程
gtjb	攻击
gtko	路口
gtlf	故里
gtlp	路旁
gtlr	故意
gtlt	攻略
gtlv	路边
gtos	攻读
gtpk	故宫
gtre	故人
gtsa	路上
gtsg	故居
gtsi	故事
gttc	路径
gtvj	攻打
gtvl	攻势
gtvy	路途
gtwv	故作
gtxf	攻防
gtxg	路线
gtxl	故障
gtxv	故乡
guaq	古董
guax	广东
guba	古巴
guda	广大
gudb	古典
gudi	广电
gufh	古老
gufn	广场
gufr	弱者
gufw	古城
gugg	鬼子
gugw	豆腐
guhk	弱点
guiv	广泛
guke	古玩
gulo	古龙
gume	鬼脸
gumf	古墓
gumi	广阔
gunc	古怪
guol	广为
guqs	古镇
guqy	广角
gure	古人
gusk	弱智
gutk	广告
gutl	古籍
gutv	广州
guus	古装
guux	豆浆
guvl	弱势
guwn	古今
guwy	古代
guxi	广西	弱小
guyo	古迹
gvai	跌落
gvbv	退还
gvcs	康熙
gvfs	退款
gvhe	退税
gvhm	唐朝
gvjg	跌幅
gvjj	退出
gvlk	退回
gvlv	摩托罗拉
gvof	唐诗
gvtj	退役
gvtr	康复
gvwb	庸俗
gvwc	跌倒
gvwf	康佳
gvwo	退休
gvwq	退货
gvwu	唐僧
gvwy	唐代
gvxp	庭院	退缩
gwbt	腐败
gwhq	鞭炮
gwhu	腐烂
gwli	魅力
gwqc	腐蚀
gwse	跻身
gxel	邯郸
gxgg	孙子
gxgx	或多或少
gxof	素材
gxqb	逊色
gxrs	素质
gxuo	素有
gxuy	素养
gxva	素描
gxwg	素食
gydj	序列
gyga	蹂躏
gykg	序号
gymj	序幕
gzco	跳蚤
gzec	跳动
gzfo	跳过
gzgv	跳跃
gzjj	跳出
gzoc	跳槽
gzom	跳楼
gzsu	跳水
gztd	跳舞
haga	烘干
hatf	虐待
hbfa	秘方
hbon	秘诀
hbpb	秘密
hbsu	秘书
hbtj	秘笈
hbtl	具备	秘籍
hbuo	具有
hbvs	秘技
hbwd	具体
hcap	私营
hcdp	皮带
hcge	皮革
hcgf	皮鞋
hchb	颇具
hchf	私房
hcip	私下
hciw	烛光
hckb	雇员
hcli	私立
hcma	皮毛
hcmb	私服
hcmf	皮肤
hcok	雇主
hcol	颇为
hcow	私语
hcps	私家
hcqs	皮包
hcre	私人
hcuo	私有	颇有
hcwy	雇佣
hczi	私自
hdgk	烦躁
hdnw	烦恼
hdor	稽查
hear	稻草
hefb	税费
hehh	税收
hetl	税务
heyx	税率
hfax	房东
hfgg	房子
hfhq	房租
hflc	房产
hfme	房门
hfmr	房间
hfnr	烤肉
hfsc	房屋
hfwv	房价
hgab	季节
hgga	季度
hghf	烧烤
hgjd	煤炭
hgpc	季军
hgqi	煤气
hgsg	煤矿
hhaf	收获
hhan	收藏
hhax	北欧
hhay	炎黄
hhbq	收购
hhce	乘车
hhcf	收到
hhco	收集
hhda	北大
hhde	剩的
hhdl	背面
hhec	收取	煽动
hhei	收敛
hhej	背叛
hhfa	北方
hhfb	收费
hhfc	收发
hhfl	此地
hhfn	收场
hhfs	收款
hhgd	此项
hhgt	北路
hhhg	秋季
hhhh	频频
hhhj	此刻
hhhz	此种
hhii	此举
hhip	剩下
hhit	北海
hhiw	紫光
hhiy	柴油
hhkj	收听
hhlk	收回	北部	背部
hhlr	收音
hhmd	此类
hhme	步骤
hhmr	此间
hhmx	秋风
hhng	煽情
hhoj	乘机	北极
hhov	些许
hhpm	收视
hhpn	此案
hhpt	乘客
hhqb	紫色	背负
hhqg	收银
hhqi	秋千
hhqs	背包
hhre	此人
hhrf	此时
hhrg	背后	此后
hhri	秋日
hhrm	收看
hhrr	乘坐
hhry	背景	背影
hhsa	北上
hhsc	收支
hhsi	此事
hhsu	秋水	此书
hhte	步行
hhti	秋天
hhtm	频繁
hhtp	此处
hhtu	秋冬
hhub	收益
hhud	北美
hhum	此前
hhuq	此次
hhus	频道	北斗
hhve	收拾
hhvg	此生
hhvk	紫金
hhvo	炎热
hhvs	收录
hhvy	收入	步入	剩余
hhwe	此文
hhwg	步伐
hhxi	背心
hhxp	此外	收缩
hhyu	秋雨
hhyx	北京	频率
hhzm	收盘
hhzn	收起
hihi	稍稍
hirg	稍后
hitj	稍微
hiuo	稍有
hiwh	稍候
hjag	刻苦
hjgf	颓废
hjhb	灯具
hjhu	灿烂	灯火
hjif	利于
hjil	刻画
hjim	利润
hjiq	灯泡
hjiw	灯光
hjkq	利器
hjlr	刻意
hjmm	刻骨
hjng	利好
hjpf	利害
hjqt	灯饰
hjsx	利息
hjtl	灯笼
hjub	利益
hjvs	刻录
hjyo	利用
hjyx	利率
hkap	启蒙
hkay	积蓄
hkbd	积分
hkbo	占卜
hkcf	积压	点到
hkdc	战友
hkec	启动
hkfc	启发
hkfl	占地
hkfn	战场
hkga	程度
hkgg	点子
hkgy	程序	和弦
hkhk	点点	启程
hkhq	点燃
hkhu	战火	点火
hkil	点滴
hkim	和尚
hkjb	点击
hkjk	点歌
hkko	点球
hklk	战国
hklt	战略
hklx	积累
hkmf	和睦
hkmn	点数
hkmv	战胜
hkng	和好
hkoj	积极	战机
hkoo	战术
hkop	点评
hkox	和谐
hkpi	和平
hkqg	点钱
hkqv	战争
hkqy	和解
hkrg	战后
hksi	战士	启示	启事
hktj	战役
hkud	点头	和美
hkum	战前
hkuo	占有
hkus	战斗
hkvp	程控
hkvs	占据
hkvv	点播
hkwc	占领
hkxc	点缀
hkxg	战线	战绩
hkxi	点心
hkxk	点名
hkxr	战队
hkyg	程式
hkyo	占用	启用
hkyp	点亮
hkyv	启迪
hlar	烟草
hlaw	烟花
hlck	烟台
hlhb	烟具
hlhu	烟火
hliy	烟酒
hlyt	烟雾
hlyu	烟雨
hmdj	遍布
hmfl	遍地
hmji	遍及
hmml	肩膀
hmpg	肯定
hmqb	肩负
hmqi	朝气
hmsa	肩上
hmti	朝天
hmum	朝着
hmvm	朝向
hmvs	朝廷
hmxr	朝阳
hmyy	朝鲜
hnfc	秀发
hnfo	透过
hnim	秀丽
hnjj	透出
hnkb	委员
hnpm	透视
hnqi	透气
hnrm	透明
hnsc	透支
hnsj	委屈
hnta	透彻
hnud	秀美
hnve	委会
hnvv	委托
hnyg	透露
hoba	黑白
hocf	以致	以至	以对
hodo	以太
hodx	黑帮
hoek	墨盒
hofd	默契
hohh	以此
hoho	默默
hoih	黯淡
hoim	以来	黑洞
hoip	以下
hoji	以及
homa	黑马
homi	以免
homj	黑幕
hone	以内
hool	以为
hooo	以求
hoor	默认	黑板
hopt	黑客
hoqb	黑色
hoqi	以其
hoqu	黯然
hore	黑人
horg	以后
horl	黑暗
hosa	以上
hosu	墨水
hoto	以往
houm	以前
hous	黑道
howa	以供
howg	以便
hoxf	以防
hoxp	以外
hoye	黑衣
hoyw	黑夜
hpsk	睿智
hqcc	炮轰
hqce	租车
hqfc	焕发
hqhf	租房
hqhg	燃烧
hqhh	稳步
hqiy	燃油
hqkg	称号
hqkh	称呼
hqlg	稳固
hqmt	粗糙
hqmu	燃料
hqol	称为
hqpg	稳定
hqqi	燃气	称其
hqql	稳重
hqra	粗暴
hqrm	黎明
hqte	称赞
hqvk	租金
hqwv	租赁	称作	稳健
hqyg	称霸
hqyo	租用
hrac	香蕉
hrar	香草
hrce	香车
hrde	旧的
hrdf	旨在
hrdl	桌面
hrfc	爆发
hrgg	桌子
hrhl	香烟
hrhv	爆炸
hria	香港
hrjj	爆出
hrkw	香味
hrmu	香料	爆料
hrod	桌椅
hrop	香槟
hrpr	旧版
hrqi	香气
hrsa	桌上
hrsu	香水	旧书
hrvl	焊接
hrzh	卓越
hscc	疑难
hsgk	疑惑
hshx	疑虑
hsih	熄灭
hsmk	疑问
hspm	歧视
hswh	疑似
htfs	乾坤
htgd	肇庆
hthu	烽火
htqi	烙印
htsi	肇事
htxt	乾隆
huaw	火花
huca	科长
huce	火车
huey	科普
hufg	科教
huha	火炬
huhg	火烧
huhh	火柴
huhq	火焰
huhr	火爆
huip	科学
huje	火山
hukj	户型
huko	户口
huli	火力
humu	科目
huoj	火机
hupc	科室
huph	火灾
huqk	火锅
hurv	火星
husk	科研
hutl	户籍
hutu	火箭
huvo	火热
huvs	科技
huxg	火红
huxo	科幻
huxp	户外
hvax	炸药
hvge	炸弹
hvgy	秩序
hvtj	遏制
hwiy	韩流
hwlk	韩国
hwow	虔诚
hwsg	韩剧
hxcb	惠顾
hxcf	移到
hxcj	餐厅
hxec	移动
hxey	惠普
hxhb	餐具
hxhr	餐桌
hxix	灯红酒绿
hxjv	稍纵即逝
hxlx	移交
hxmj	炒股
hxnh	移民
hxos	移植
hxqp	餐馆
hxqq	餐饮
hxqz	秒钟
hxtv	惠州
hxuo	稀有
hxvm	稀释
hxwv	炒作
hxxv	稀少
hyap	虚荣
hygg	稿子
hygu	虚弱
hyid	虚无
hyiw	炫耀
hyoq	虚构
hyvh	虚拟
hywn	虚假	稿件
hywo	虚伪
hyxo	虚幻
hzfl	止境
hzft	种族
hzgg	种子
hzhz	种种
hzmd	种类
hzos	种植
hzwo	止住
iabd	满分
iack	港台
iaco	汇集
iadl	满面
iaec	汇聚
iaee	港元
iaek	汇总
iafe	汇丰
iafl	满地
iafs	汇款
iaij	灌溉
iail	港湾
iais	泄漏
iaiv	港澳
iaix	潇洒
iakh	满足
iako	港口
ialr	满意
iame	满脸
iamu	满目
ianb	满怀
iase	满身
iasu	洪水	灌水
iati	满天
iatj	灌篮
iaus	渠道
iavb	汇报
iavj	港币
iaxh	汇编
iaxi	满心
iayg	泄露
iayx	汇率
ibai	激荡
ibcw	激励
ibdj	激烈
ibec	激动
ibfc	激发
ibfg	浴缸
ibgx	激素
ibhk	激战
ibiq	激活
ibiw	激光
ibme	测验
ibng	激情
ibop	测评
iboy	测试
ibpc	浴室
ibpg	测定
ibri	测量
ibss	泌尿
ibtm	测算
ibxv	测绘
ibzn	激起
icbs	源泉
icec	涌动
icem	治愈
icft	汉族
icfw	汉城
icgg	汉子
ichh	淮北
ichn	渗透
icic	渐渐	源源
icif	涟漪	源于
icjj	涌出
icjv	渐进
ickl	治理
ickm	涌现
iclk	治国
icng	治好
icow	汉语
icpg	汉字
icpn	治安	淮安
icsm	淮南	源码
icud	源头
icui	治病
icul	治疗
icvy	涌入
icwk	汉堡
icwq	汉化
iczi	源自
iczo	汉中
idbu	无不
idcc	无双
idcm	无能
idds	无奈
ided	无须
ideh	无耻
ideq	无聊
idet	无关
idfe	无非
idfg	无垠
idgl	无辜
idgq	无底
idgt	无故
idhc	无私
idhs	无疑
idif	无法
idii	无一
idij	淹没
idik	无常
idir	正大光明
idje	梁山
idke	无形
idkl	无理
idkw	无味
idlf	无罪
idli	无力	无畏
idlj	无端
idlr	无意
idlv	无边
idlx	无效
idmn	无数
idmr	无间
idnd	无忧
idng	无情	无愧
idnt	无悔
idoc	无权
idoj	无机	无极
idok	无误
idol	无为	无谓
idov	无论
idow	无语
idpf	无害
idpk	梁祝
idpl	无穷
idpm	无视
idqk	无敌
idql	无助
idqm	无期
idqr	无锡
idrg	滞后
idrn	无暇	无所
idrr	无从
idsa	无异
idsd	无题
idsk	无知
idsn	无声
idsq	无赖
idsy	无尽
idtp	无处
idug	无痕
idvk	无损
idwi	无偿
idwm	无望
idxg	无限	无线
idxh	无比
idxi	无心
idxk	无名
idxt	无缝
idxx	无缘
idyd	无需
idyk	无言
idyo	无用
ieaf	三菱
ieba	三八
iebd	三分
iecv	三轮
ieda	三大
iedr	三百
ieec	浮动	浮云
ieee	三元
iegk	浮躁
iehh	三步
iehj	淫秽
iehk	三点
iehz	三种
ieie	滔滔
ieig	三江
ieij	污染
iejj	三峡	浮出
iekb	三只
iekm	浮现
iele	三四
ielk	三国
iemd	三类
iemm	三月
ieoh	洽谈
ieoy	尝试
ieqy	三角
ieri	三日
ierm	三明
ierv	三星
iesi	三十
ievh	三个
iewy	三代
iexc	三维
iexj	三级
ieya	三亚
ifai	游荡
ifax	浦东
ifbj	法则
ifcg	游戏
ifcm	潜能
ifdf	潜在
iffm	法规
ifgg	法子	游子
ifgv	法庭
ifhh	于此
ific	法治
ifio	游泳
ifip	法学
ifjb	游击
ifji	法师
ifjt	游览
ifke	游玩
ifli	潜力
iflk	法国
ifmu	沸腾
ifmx	法网
ifnh	游民
ifon	游记
ifow	法语
ifpg	法定
ifpk	法宝
ifpn	法官
ifpt	游客
ifqx	游乐
ifre	法人	游人
ifrs	潜质
ifsi	于是
ifsu	潜水
ifte	游行
iftj	法制
iftv	法律
ifvy	潜入
ifwb	游离
ifwc	法令
ifwj	游侠
ifwq	潜伏
ifxp	法院
ifzv	潜艇
igal	江苏
igba	清白
igbs	清泉
igdx	清爽
igee	清远
igel	清单
iggm	清静
iggv	涨跌
ighh	湖北	江北
ighm	清朝
ighn	清秀
ighr	清香
igib	湖泊
igic	江淮
igig	江湖
igih	清淡
igij	江河
igis	清洁
igit	清洗
igiy	清澈
igje	江山
igjg	涨幅
igkl	清理
igle	湖畔	涨了
igln	清楚
igls	清新
iglv	湖边
igme	江门
igmq	清脆
igmx	清风
igoh	浅谈
igoj	浅析
igpg	清空
igrc	清晨
igrm	清明
igro	清晰
igsm	江南	湖南
igsu	汗水	湖水	清水
igtm	清算
igtv	湖州
iguq	清净
iguy	清凉
igwq	清华
igwv	涨价
igwy	清代	涨停
igxi	江西
igxm	江阴
igxt	清纯
igxv	清除
igyr	清醒
ihda	正大
ihdf	正在
ihdl	正面
ihec	波动
ihfm	正规
ihgw	政府
ihhu	灭火
ihhw	潜移默化
ihic	政治
ihif	政法
ihih	淡淡	婆婆
ihik	正常	政党
ihim	波澜
ihio	波浪
ihir	潮湿
ihiv	正当
ihiy	潮流
ihji	涉及
ihjj	淡出
ihjt	濒临
ihkh	涉足
ihkk	正品
ihmm	正月
ihnf	波特
ihng	正好
ihnj	涉嫌
ihnk	正如
ihoc	政权
ihoo	渴求
ihox	正义
ihpm	正视
ihpn	涉案
ihpr	正版
ihps	正宗
ihqi	正气
ihqj	波斯
ihql	滤镜
ihqu	淡然
ihsh	正直
ihsi	正是
ihsl	政协
ihsq	正确
ihsu	潮水	淡水
ihtj	政策
ihtl	政务
ihtv	泸州	潮州
ihue	波兰
ihwa	灭亡
ihwe	正文
ihwf	正传
ihwm	渴望
ihwq	淡化
ihws	正值
ihxc	正经
ihxn	正要
ihxp	涉外
ihxq	灭绝
ihxw	波纹
ihyg	正式	波霸
ihzo	正中
iiab	一共
iiad	一切
iiae	一匹
iian	一世
iibd	一分
iibj	一则
iicc	一双
iicf	一对	一致	兴致
iick	一台
iicl	一辆
iicv	一轮
iicy	一通
iidc	一套
iidj	一段
iidl	一面	兴奋
iidp	一带
iidr	一百
iidx	一帮
iiec	举动
iiee	一元
iiej	一半
iiek	一并
iifb	消费
iifc	一堆
iifn	一块	一场
iifs	一款
iiga	一度
iigc	一张
iigd	一项
iigl	消磨
iigm	消毒
iigo	一盏
iigr	一座
iigt	一路
iihb	一具
iihg	一季
iihh	一些	一步
iihj	一刻
iihk	一点
iihm	一遍
iihx	一秒
iihz	举止
iiih	消灭
iiii	一举
iiik	一堂
iiil	一滴
iiim	一来
iiip	一下
iiir	一再	一派
iiiy	一流
iijb	一击
iijg	一幅
iijj	一出
iijo	一朵
iijt	一览
iijx	一岁
iikb	一员	一只
iikg	一号
iikw	一味
iilb	举办	一贯
iilf	一团
iili	一两
iilk	一回	一部	兴国
iilm	消耗
iilo	一颗
iilp	一旁
iils	一新
iilu	一圈
iilv	一边
iimd	一类	漫无目的
iime	一脸	一门
iimf	一脚	一周
iimg	一同	一眼
iimj	一幕	一股
iiml	一粒
iimm	一月
iimr	一间
iink	一如
iioa	一栋
iiob	一杯
iioe	一说
iiog	一根
iioj	消极
iiol	誉为	一棵
iiom	一想	一楼
iioo	一米
iios	一枝
iiot	一枚
iiov	一枪
iioy	一样
iipg	一定	一字
iipi	一片
iips	一家	一审
iiqi	一千
iiqk	一句
iiqy	一角
iirf	一时
iiri	一旦	一晃	一日
iirk	兴旺
iirm	一晚
iirn	一所
iirs	一早
iisc	一支
iise	一身	一层
iish	一直
iisl	消协
iisn	一声
iiso	一手	举手
iisp	一碗
iisx	消息
iisy	一届
iita	一年
iitd	一顿
iite	举行	一行
iitf	一等
iith	一篇
iiti	一天
iits	一条
iitv	一律
iiud	一头
iiuo	一有
iiuq	一次
iius	一道
iiva	举措
iivb	举报	一把
iive	一会
iivf	消失	一排
iivg	一生
iivh	一个
iivj	消逝
iivm	一番	一向
iivp	兴建
iivx	一批
iiwa	一万
iiwb	一侧	一份
iiwd	一体	举例	一例
iiwj	一齐
iiwl	一位
iiwn	一件
iiwq	消化
iiwy	一代
iixc	一阵	一经
iixf	消防
iixg	一线
iixi	一心
iixj	一级
iixm	一缕
iixr	一队
iixt	兴隆
iixv	消除
iixx	一丝
iiye	兴业
iiyk	一群
iiyw	一夜
iize	兴趣
iizi	消遣
iizj	一般
iizn	一起	举起	兴起
ijbv	河谷
ijcg	没劲
ijcm	没能
ijec	汲取
ijhh	河北	没收
ijic	河源
ijif	没法
ijim	没来
ijit	沿海
ijiy	河流
ijkv	没啥
ijle	河畔	没了
ijlv	河边
ijmu	染料
ijpe	没完
ijqa	没错
ijqb	染色
ijre	没人
ijsa	染上
ijsi	没事
ijsm	河南
ijsu	河水
ijud	汕头
ijum	沿着
ijuo	没有
ijvy	沿途
ijxg	沿线
ijyo	滥用	沿用	没用
ikfm	常规
ikhn	党委	常委
ikih	党政
ikik	常常
ikkb	党员
ikme	掌门
ikmq	常见
ikoa	掌柜
ikoe	常说
ikoj	赏析
ikok	常识
ikol	党校
ikre	常人
iksa	掌上
iksn	掌声
ikta	常年
iktl	常务
ikts	常德
iktv	常州
ikvp	掌控	党建
ikvs	掌握
ikxi	掌心
ikxq	党组
ikyg	常熟
ikyo	常用
ilce	画册
ildl	画面
ilec	滚动
ilfg	池塘
ilgo	画廊
ilib	淋浴
ilil	滚滚	画画
iliw	淋漓
iljj	画出
ilps	画家
ilrs	画质
ilsa	画展
ilse	滚屏
ilsu	滴水
iltv	漳州
ilvb	画报
ilwx	画像
imai	渺茫	滑落
iman	来世
imcf	来到
imcl	来历
imdi	来电
imef	逍遥
imfc	来去
imfo	来过
imgu	削弱
imhd	滑稽
imhh	来此
imic	来源
imid	尚无
imig	丽江
imim	润滑
imjt	来临
imka	敞开
imkb	来吧
imle	来了
imlk	来回
imns	来函
imoe	来说
imof	来访
imoj	来讲
imor	滑板
impq	来宾
impt	来客
impw	洞察
imre	来人
imrf	来时
imrm	来看
imsu	泪水	丽水
imto	来往
imtp	海阔天空
imtr	来得
imuw	削减
imvg	来生
imvl	来接
imvs	一网打尽
imwe	尚未
imwx	肖像
imwy	来信
imxi	渺小
imyv	滑雪
imzi	来自
inbk	与否
inhh	与此
injt	一如既往
innm	汤姆
inon	与之
inqi	与其
inre	与人
inum	涵盖
inve	与会
ioaw	浪花
ioce	注册
iofb	浪费
iogg	浪子
ioho	漆黑
ioib	沐浴
ioih	浪潮
ioir	浪漫
ioix	湘潭
iolr	注意
iomu	注目
iopg	注定
iopm	注视
ioqi	注销
ioql	注重
ioqm	末期
iori	末日
iorm	注明
iosf	注射
ioum	注塑
ious	泳装
iovm	注释
iovy	注入
ipad	深切
ipai	下落
ipaj	深蓝
ipay	演艺
ipba	下巴
ipbd	学分
ipce	下车
ipcg	演戏
ipcl	学历
ipcr	深厚	浓厚
ipdc	学友	下载
ipdj	下列	浓烈
ipdl	下面
ipdt	演奏
ipdv	下达
ipee	深远
ipel	下单
ipep	深受
ipfa	下方
ipfb	学费
ipfc	下去	下发
ipfj	深圳
ipfn	下场
ipfr	学者
ipga	深度	浓度
ipgg	学子
ipgm	沉静
ipgv	下跌
ipgw	学府
iphh	深秋
iphj	深刻
iphk	学点
ipho	沉默
iphq	沉稳
iphu	学科
ipie	沉浮
ipif	下游
ipig	沉溺
ipij	渲染
ipim	下来	下滑
ipip	深沉	沉淀
ipit	深海
ipiv	沉浸	深渊	沉沦
ipiy	下流	溶液
ipje	下山	深山
ipjj	演出
ipjm	下岗
ipkb	演员
ipkj	下班
ipkr	演唱
iplc	演变
iple	学园
iplv	学界
iplx	沉思	深思
ipmb	淀粉
ipmc	沉睡
ipmf	下周
ipmk	学问
ipmm	下月
ipmv	沉迷
ipmx	沉闷
ipng	深情	学好
ipnw	觉悟
ipoe	演说	学说
ipoj	演讲	下设
ipol	学校	下课
ipom	下楼	下调
ipoo	学术
ipox	演义
ippe	深邃
ippg	下定
ipps	学家	沉寂
ipql	沉重
ipqm	学期
ipqr	下旬
ipqu	浑然
ipqy	溶解
ipse	浑身	下身	深层
ipsi	学士	演示
ipsk	深知
ipso	下手
ipsu	下水
ipsy	下属
ipta	学年
iptk	深造
iptp	深处
iptr	觉得
ipum	沉着	学前
ipuq	下次
ipux	浓郁
ipvb	学报
ipve	学会
ipvg	学生	下午
ipvl	下拉
ipvs	演技
ipvy	深入
ipwc	下令
ipwe	下文
ipwg	深感
ipwj	溶剂
ipwl	学位
ipwq	深化
ipwy	深信
ipxc	演绎
ipxg	下线
ipxi	学习	演习
ipxj	下级
ipxl	演练
ipxp	学院	浓缩
ipxr	沈阳
ipxt	下降
ipxv	下乡
ipye	学业
ipyr	觉醒
ipyu	下雨
ipyv	下雪
ipyw	深夜
ipyy	沉醉
iqaj	湛蓝
iqce	汽车
iqcy	沟通
iqec	活动
iqgv	活跃
iqid	淘汰
iqif	活泼
iqig	湛江
iqii	泡沫
iqiy	汽油
iqle	溜了
iqli	活力
iqnn	泡妞
iqnv	活性
iqpf	活塞
iqpk	淘宝
iqqi	淘气
iqsh	沮丧
iqvk	淘金
iqyn	汽配
irbs	温泉
irbu	再不
irca	漫长
ircf	派对
irdj	瀑布
irek	混合
irfr	再者
irga	再度	温度	湿度
irhh	漫步
irhk	温和
irie	再三
irif	漫游
iril	漫画
irim	湿润	再来
irir	混混	漫漫
irit	混沌
irix	混淆
irjj	派出
irkm	再现
irlu	再也
irmq	再见
irng	温情	再好
irnh	混蛋
iroe	再说
iroh	漫谈
irpc	温室
irqk	混乱
irre	温暖	派人
irsn	温馨
irti	漫天
irtk	再造
irtv	温州
iruq	再次
iruv	湿疹
irvb	再创
irvg	再生
irvm	混血
iryv	温柔
irzi	派遣
irzn	再起
isba	洁白
isff	泥土
ishb	洁具
isim	漏洞
isit	渤海
isle	漏了
isnv	淑女
isuq	洁净
itax	海东
itbg	海贼
itcl	海螺
itdl	海面
itet	海关
itfc	洗发
itfg	海域
itgq	海底
itib	洗浴
itic	海滩
itih	浩瀚
itik	洗澡
itil	海湾
itio	海浪
itip	海滨
itit	洗涤
itiy	海洋
itjc	海岸
itjj	海峡
itjv	海归
itko	海口
itlf	海里
itlk	添加
itlo	海龙
itlv	海边
itme	洗脸
itms	海豚
itmx	海风
itpc	海军
itpj	海宁
itpn	洗礼
itpr	洗牌
itqx	海尔
itri	海量
itsa	海上
itsm	海南
itso	洗手
itsu	海水
itti	海天
ituq	海盗	洗净
itvb	海报
itvd	海拔
itwy	海信
itxb	海绵
itxp	海外
itxr	洛阳
itye	洗衣
ityy	海鲜
iuim	滋润
iujj	溢出
iukk	无病呻吟
iukw	滋味
iuuy	滋养
iuvg	滋生
ivai	沦落
ivbh	津贴
ivcc	沧桑
ivdl	当面
ivfl	当地
ivfn	当场
ivic	渊源
ivig	浙江
ivij	泛滥
ivip	当下
iviq	浸泡
ivit	沧海	澳洲
ivjb	当即
ivme	澳门
ivmu	涂料
ivol	沦为
ivpd	当初
ivps	当家
ivqb	当兵
ivqu	当然
ivrf	当时
ivri	当日
ivrm	当晚
ivsa	当上
ivsf	淄博
ivsh	当真
ivsi	当事
ivsn	当局
ivta	当年
ivte	当选
ivti	当天
ivtv	沧州
ivud	当头
ivum	当前
ivvi	涂抹
ivvr	当众
ivwn	当今	当成
ivwv	当作
ivwy	当代
ivxg	当红
ivxi	当心
ivyn	涂鸦
ivzn	泛起
ivzo	当中
iwap	光荣
iwaw	光芒
iwcb	光顾
iwda	光大
iwdi	光电
iweo	光彩
iwhb	辉煌
iwic	光泽	光源
iwig	澄清
iwim	光滑
iwip	光学
iwiw	光辉
iwjt	浏览	光临
iwkb	光环
iwma	光驱
iwmg	耀眼
iwor	光棍
iwpj	济宁
iwrd	光照
iwrm	光明
iwry	光影
iwsa	光碟
iwsm	济南
iwud	光头
iwwq	光华
iwxg	光线
iwxj	光缆
iwxm	光阴
iwxq	光纤
iwxr	濮阳
iwyp	光亮
iwzm	光盘
ixbu	互不
ixcy	互通
ixec	互动
ixee	互联
ixfc	沙发
ixff	潍坊
ixgg	沙子
ixhj	互利
ixhx	互惠
ixib	漂泊
ixic	汹涌	沙滩
ixie	漂浮
ixim	沙漠
ixir	澎湃
ixiy	漂流
ixlo	沙龙
ixme	洒脱
ixnf	沙特
ixom	互相
ixpp	互补
ixql	互助
ixvq	互换
ixyp	漂亮
ixyu	鲨鱼
iyaq	武警	洋葱
iycf	液压	流转
iycv	流连
iycy	流通
iyec	流动
iyek	酒瓶
iyfg	流域
iygh	酒店
iygl	武功
iyhj	流利
iyhk	流程
iyhl	油烟
iyho	油墨
iyic	武汉
iyii	流淌
iyil	油画
iyim	流泪
iyio	流浪
iyip	流下
iyiu	洋溢
iyjj	流出
iykb	酒吧
iykq	武器
iylc	流产
iyli	武林	武力
iyll	油田
iymd	酒类
iymg	酒精
iymh	油脂
iyob	酒杯
iyom	酒楼
iyoo	武术
iyps	酒家
iyrg	酒后
iyri	流量
iyrr	武昌	液晶
iyrv	流星
iysi	武士
iysn	流畅
iysu	流水
iyta	流年
iyte	流行
iyus	武装
iyvf	流失
iyvj	流逝
iyvm	流血	流向
iyvy	流入
iywd	液体	流体
iywf	流传
iywg	流感
iywj	武侠
iywn	流氓
iywq	液化
iywv	油价
iyye	渔业
iyyg	流露
iyyk	流言
izun	溃疡
izvq	囊括
jabu	既不
jacm	既能
japg	既定
jaqu	既然
jasi	既是
jauo	既有
jaxn	既要
jbbt	击败
jbdf	即在
jbhj	即刻
jbjk	即可
jbol	即为
jbrf	即时
jbux	即将
jbwg	即便
jbwl	即使
jbyo	即用
jbzo	击中
jcbv	紧迫
jcfn	紧缺
jcgc	紧张
jcgg	紧跟
jcgk	坚强
jchu	帐户
jcjc	紧紧
jclg	坚固
jcls	崭新
jclv	岸边
jcmf	紧闭
jcmj	帷幕
jcpb	紧密
jcpf	坚守
jcpg	坚定
jcpu	坚实
jcqv	紧急
jcse	紧身
jcsg	坚硬
jctt	帐篷
jcud	紧凑
jcun	坚决
jcvf	坚持
jcvl	紧接
jcvs	紧握
jcwd	坚韧
jcwy	坚信
jcxn	紧要
jcxp	紧缩
jczn	竖起
jdjt	顶峰
jdlj	顶端
jdlk	顶部
jdsa	顶上
jdxd	顶尖
jdxj	顶级
jdxx	顶多
jeax	山东	山区
jebv	山谷
jefh	山坡
jefl	山地
jegf	山庄
jegt	山路
jeij	山河
jeim	山洞
jeip	山下
jejd	山顶
jejh	山川
jejt	山峰
jeli	山林
jemo	山脉
jeof	山村
jesa	山上
jesu	山水
jexi	山西
jeya	山羊
jgga	幅度
jgih	毁灭
jgle	毁了
jgvy	嵌入
jhgg	帖子
jhgi	顺应
jhgy	顺序
jhhj	顺利
jhmg	顺眼
jhmx	顺风
jhos	鼠标
jhsn	顺畅
jhso	顺手
jhts	顺德
jhum	顺着
jhvl	顺势
jhwg	顺便
jhxi	顺心
jiai	师范
jiap	兼营
jibd	几分
jibx	师父
jicb	兼顾
jida	师大	九大
jidr	几百
jiek	兼并	兼职
jiex	师弟
jigc	几张
jihb	兼具
jihh	几步
jihk	几点
jihu	几乎
jihz	几种
jiig	九江
jiip	几下
jijs	夹杂
jikb	几只
jike	师兄
jilo	九龙
jimm	九月
jinq	师姐
jiot	及格
jipv	兼容
jiqi	及其	几千
jiqk	几句
jirf	及时	几时
jirs	及早
jisi	几十
jisy	九届
jita	几年
jiti	九天	几天
jits	几条
jitv	九州
jiuq	师资	几次
jivg	师生
jivh	几个
jiwa	几万
jiwf	师傅
jiwj	几何
jiwn	九成	几件
jixc	几经
jixj	甲级
jiya	甲醛
jiyx	几率
jjan	出世
jjbv	峡谷
jjca	出厂
jjcj	出轨
jjck	出台	出售
jjdf	出在
jjdj	出奇
jjdl	出面
jjec	出动
jjfc	出去	出发
jjff	出土
jjfl	出境
jjfn	出场
jjga	出席
jjgt	出路
jjhb	出具
jjhh	出炉
jjhq	出租
jjhr	丁香
jjhu	出乎
jjib	刺激
jjif	出于	出游
jjij	出没
jjim	出来
jjip	出演
jjit	出海
jjjb	出击
jjjk	帅哥
jjkk	出品
jjkm	出现
jjko	出口
jjle	出了
jjlk	出国
jjme	出门
jjoc	斤斤计较
jjof	出访
jjos	出让
jjpr	出版
jjqa	出错
jjqb	出色
jjqg	出钱
jjqi	帅气
jjse	出身
jjsi	出事	出示
jjsn	出卖	出声	出局
jjso	出手
jjte	出行
jjti	出征
jjtp	出处
jjuc	刺痛
jjud	出头
jjug	出差
jjuq	出资
jjus	出道
jjvg	出生
jjvm	出血
jjvr	出众
jjvy	出入
jjwq	出货
jjwv	出任	出价
jjxg	出线
jjxh	刺绣
jjxk	出名
jjxp	出院
jjzi	出自
jjzo	出走
jkbk	可否
jkcm	可能	可观
jkdv	可达
jkeh	可耻
jkep	可爱
jkfe	歌坛
jkfx	可悲
jkho	可以
jkhs	可疑
jkjk	哥哥
jkkl	可别
jkko	可口
jkkr	歌唱
jkmq	可见
jkmv	歌迷
jkna	可惜
jknb	可怕
jknw	可怜
jkol	可谓
jkom	可调
jkon	歌词
jkpm	可视
jkqu	歌曲
jkqx	可乐
jkrm	可看
jkrv	歌星
jksg	歌剧
jksi	可是
jksk	可知
jksn	歌声
jkso	歌手
jktd	歌舞
jkte	可行	可选
jktk	可靠
jktr	可得
jktv	可笑
jkuo	可有
jkux	可将
jkvm	可向
jkwa	可供
jkwg	可做
jkwl	可使
jkwm	可望	哥们
jkwy	可信
jkxh	可比
jkxk	可喜	歌名
jkxn	可要
jkyk	可言
jkyo	可用
jkyx	可恶	可就
jkzi	可贵
jlap	勤劳
jldl	勤奋
jmiz	崩溃
jmwl	岗位
jnbu	岂不
jncm	岂能
jnft	凯旋
jngg	鸭子
jojo	朵朵
jore	凡人
josi	凡是	凡事
jpim	崇尚
jpri	崇拜
jpwe	崇文
jpym	崇高
jqik	欣赏
jqlr	歉意
jqqu	欣然
jqss	欣慰
jqxk	欣喜
jqzq	顺其自然
jrgg	帽子
jrri	旭日
jsjt	巅峰
jsoh	杂谈
jsqb	杂锦
jsqk	杂乱
jssi	岩石
jssx	杂志
jswe	杂文
jswq	杂货
jszn	崛起
jtfo	监狱
jtgo	临床
jtib	监测
jtif	鉴于
jtij	临沂
jtik	鉴赏
jtjv	临近
jtkj	监听
jtkl	鉴别	监理
jtpg	鉴定
jtpm	监视
jtpw	监察
jtrf	临时
jtsx	监督
jttj	监制
jttp	监管
jtve	峰会
jtvh	监护
jtvp	监控
jtzo	临走
jvbv	归还
jvdm	进而
jvdr	近百
jvec	进取
jvfc	进去
jvfw	进城
jvga	进度
jvgt	进攻
jvhh	进步
jvhk	进程
jvhu	近乎
jvif	归于
jvim	进来	近来	归来
jvjj	进出
jvko	进口	进球
jvmd	归类
jvmo	进驻
jvoi	归档
jvpc	进军
jvpm	近视
jvpw	归宿
jvqm	近期
jvri	近日
jvsa	进展
jvsy	归属
jvta	近年
jvte	进行
jvuk	近况
jvvy	进入
jvwh	近似	进修
jvwq	进化	进货
jvwy	近代
jvxn	归纳
jvxs	归结
jvxv	进阶
jvyx	进京
jwxy	哥伦比亚
jxec	幽魂
jxho	幽默
jxio	岁末
jxjx	幽幽
jxmm	岁月
jxvh	幽灵
jxyc	幽雅
kaaw	开花
kace	开车
kacy	开通
kads	开本
kaeo	开采
kaet	开关
kafc	开发
kaff	开封
kafn	开场
kaft	开放
kagc	开张
kagh	开店
kago	开工
kagv	开庭
kahk	开启	开战
kahu	开户
kaic	开源
kaim	开来
kaip	开学
kajj	开出
kakd	唠叨
kakf	呕吐
kako	开口
kaky	哎呀
kalb	开办
kalj	开端
kame	开门
kami	开阔
kamj	开幕
kanb	开怀
kanc	开始
kaoj	开设	开朗	开机
kaol	开课
kaov	开枪
kapb	开赛
kapi	开辟
kaqi	开销
kasa	开展
kasc	开支
kasn	开局
kasu	开水
kato	开往
katr	弄得
kaud	开头
kaux	开奖
kavb	开创	开拍
kave	开会
kavs	开拓
kavv	开播
kaxi	开心
kaxv	开除
kaye	开业
kazm	开盘
kbab	环节
kbcb	只顾	只愿
kbcm	只能
kbdf	只在
kbfl	环境
kbgo	员工
kbhh	只剩
kbiv	只当
kbko	环球
kbkw	吩咐
kbld	只因
kblr	勋章
kbmq	只见
kbnb	只怕
kbng	只好
kboe	只说
kbol	只为
kbom	只想
kboo	只求
kbrm	只看
kbse	只身
kbsi	只是
kbsn	只卖
kbso	只手
kbtp	只管
kbtr	只得
kbuo	只有
kbve	只会
kbwg	只做
kbwk	环保
kbxg	环绕
kbxn	只要
kbyd	只需
kbyo	只用
kcfc	唯独
kcgg	嗓子
kcii	唯一
kcjs	嘈杂
kckg	珊瑚
kclr	嗓音
kcoe	虽说
kcqi	叹气
kcqu	虽然
kcsx	叹息
kcud	唯美
kdgc	嚣张
kecf	玩转
kedm	玩耍
kedo	形态
keex	兄弟
kefo	玩过
kehb	玩具
keif	玩法
keka	玩弄
keke	哈哈
kelr	玩意
keps	玩家
kepv	形容
keqx	玩乐
ketv	玩笑
keuq	形状
kevl	形势
kewd	形体
kewf	哈佛
kewl	瑜伽
kewn	形成
kewy	玩偶
kexi	形象
keyg	形式
kfeg	哺乳
kfjj	吐出
kfkj	哮喘
kfng	嗜好
kfvm	吐血
kgdk	号召
kghq	号称
kgsm	号码
khav	喝茶
khba	嘴巴
khck	嘴唇
khee	足联
kheo	喝彩	足彩
khfe	足坛
khgi	呼应
khho	足以
khiy	喝酒
khkb	琥珀
khkh	嘿嘿	呼呼	呼叫
khki	呼吁
khkj	呼吸
khko	足球
khkq	呼唤
khks	呼啸	咳嗽
khkw	玻璃	呼喊
khlf	嘴里
khlv	嘴边
khng	叫好
khom	嘲讽
khpe	喝完
khqk	足够
khqy	嘴角
khsl	足协
khsn	呼声	叫声
khsu	喝水
khtv	嘲笑
khus	叫道
khwg	叫做
khyo	足迹
khyr	叫醒
kidh	吓死
kifb	吓坏
kire	吓人
kisi	琐事
kisy	琐碎
kitr	吓得
kjaq	刑警
kjca	班长
kjce	班车
kjcf	听到
kjdb	瑞典
kjdp	吊带
kjec	听取	吸取
kjfo	听过
kjgg	班子
kjgh	吸引
kjgm	吸毒
kjhh	吸收
kjhl	吸烟
kjif	刑法
kjip	听觉
kjiv	叮当
kjjd	吊顶
kjjk	听歌
kjkg	型号
kjkh	璀璨
kjkj	呵呵
kjks	叮嘱
kjli	听力
kjmq	听见
kjna	听懂
kjoe	听说
kjoi	听证
kjol	听课
kjoq	听话
kjpe	听完
kjpn	瑞安
kjrr	听从
kjrv	瑞星
kjsi	刑事	瑞士
kjsx	喘息
kjtr	听得
kjum	听着
kjvh	呵护
kjvm	吸血
kjvr	听众
kjxj	班级
kjxn	吸纳
kkfr	王者
kkgg	王子
kkgw	王府
kkhm	王朝
kkhz	品种
kkie	品尝
kkkk	琵琶
kkkm	呈现
kkkw	品味
kklk	王国
kklr	噪音
kklx	噩梦
kkot	品格
kkpr	王牌	品牌
kkrs	品质
kksn	噪声
kkts	品德
kkwl	品位
kkxk	品名
klbf	理财
klcf	别致
klde	别的
kldg	另存
klfc	理发
klge	别克
klgo	理工
klid	别无
klii	另一
klip	理学
klir	别再
klkf	咖啡
klkg	嘀咕
klkw	咽喉
klle	别了
kllf	别墅
klmd	另类
klnv	理性
kloe	别说
klom	理想	别想
klos	别让
klov	理论
kloy	别样
klqy	理解
klre	别人
klrm	别看
klsi	理事
klsk	理智
klte	另行
kltp	别处
kluo	另有
kluy	喂养
klvb	别把
klve	理会
klvn	别扭
klwb	别离
klwn	理念
klwq	理化
klxk	别名
klxp	另外
klya	咬牙
klyo	理由
kmdf	现在
kmfn	现场
kmim	玛丽
kmjj	现出
kmnn	现已
kmpu	现实
kmre	骂人
kmrf	现时
kmse	现身
kmte	现行
kmuo	现有
kmuq	现状
kmvk	现金
kmwn	现成	现今
kmwq	现货
kmwv	现任
kmwy	现代
kmxi	现象
kner	哪儿
knhh	哪些
knhz	哪种
knim	哪来
knkw	呐喊
knlf	哪里
knnb	哪怕
knti	哪天
knuh	瑕疵
knuo	哪有
knvh	哪个
knwl	哪位
kofn	球场
kofv	口才
koie	玉溪
kojc	口岸
kokb	球员
kokg	口号
kokw	口味
koli	玉林
komb	口服
komp	口腔
komv	球迷
konv	玉女
kooo	玉米	口述
koow	口语
kopb	球赛
koqi	口气
korv	球星
kosi	玉石
kosr	口碑
kosu	口水
kotc	口径
koud	口头
koue	玉兰
kowc	口令
kowg	口感
kowy	口袋
koxr	球队
koye	球衣
kozo	口中
kpkd	喧嚣
kpkw	喧哗
kpmy	喧闹
kqek	吻合
kqhb	器具
kqil	哭泣
kqim	吹来
kqke	咀嚼
kqkf	咆哮
kqkq	呜呜
kqni	吹牛
kqof	器材
kqog	器械
kqpn	器官
kqsn	哭声
kqwn	器件
kqyr	唤醒
kqzn	唤起
kriy	啤酒
krjj	唱出
krjk	唱歌
krpi	唱片
ksbs	喷泉
ksgg	叶子
ksgl	琢磨
ksho	喷墨
ksiv	喷涂
kskb	喇叭
ksks	喃喃
kskw	呻吟	嘱咐
kspm	鄙视
kssf	喷射
kswm	咱们
ksyt	喷雾
ktag	吃苦
ktax	吃药
kten	吃亏
kthk	吃点
ktig	吴江
ktkg	玫瑰
ktkh	吃喝
ktle	吃了
ktli	吃力
ktny	吃惊
ktpe	吃完
ktqq	吃饱
ktqr	吃饭
ktum	吃着
ktvh	吃掉
ktya	吃醋
kvan	珍藏
kvgi	响应
kvhx	珍稀
kvig	珠江
kvit	珠海
kvkk	珍品
kvkv	珍珠
kvna	珍惜
kvpk	珠宝
kvyp	响亮
kvzi	珍贵
kvzn	响起
kwkl	喉咙	玲珑
kwth	斑竹
kwus	味道
kwwm	斑斓
kxck	邢台
kxkx	嘻嘻
kxlk	吵架
kxmy	吵闹
kykw	琉璃
lbbc	办公
lbcy	贯通
lbif	办法
lbip	办学
lbkl	办理
lbng	办好
lbpn	办案
lbpy	贯穿
lbrx	力不从心
lbsi	办事
lbta	贯彻
lccm	产能
lcco	变焦
lcda	变大
lcdo	变态
lcec	变动
lcfl	产地
lcge	变革	变更
lcgo	竣工
lchh	变频
lchz	变种
lcjj	产出
lcke	变形
lckk	产品
lcme	变脸
lcmn	变数
lcmu	颜料
lcnq	产物
lcnv	变性
lcoc	产权
lcol	变为
lcom	变相
lcqb	颜色	变色
lcqi	产销
lcqv	变迁
lcrg	产后
lcri	变量	产量
lcrs	变质
lcsa	变异
lcse	变身
lcsv	变速
lctr	变得
lcvg	产生
lcvq	变换
lcwn	变成
lcwq	变化
lcws	产值
lcxo	变幻
lcye	产业
lddm	因而
ldep	恩爱
ldgg	因子
ldgx	因素
ldhh	因此
ldke	畸形
ldkl	辨别
ldlo	因果
ldoi	辩证
ldol	因为
ldor	辨认
ldos	辣椒
ldov	辩论
ldqi	因其
ldqy	辩解
ldvh	辩护
ldxb	恩怨
leax	园区
leay	园艺
leda	四大
ledl	四面
lefa	四方
lefl	园地
legk	四强
lehg	四季
lehh	了些
lehk	四点
leit	四海
lejh	四川
lekm	了吗
lele	了了
leli	园林	四六
lelk	四国
lemf	四周
lemm	四月
lems	四肢
leqy	了解
lesf	四射
lesi	了事	四十
letp	四处
letr	了得
levh	四个
lewm	了望
lfbq	团购
lfca	团长
lfdl	里面
lfec	团聚
lfel	野兽
lffb	罪犯
lfff	野猪
lfgo	罢工
lfhk	里程
lfhn	团委
lfkb	团员
lflc	野蛮
lfle	罢了
lflk	团圆
lflv	里边
lfmn	垄断
lfnv	野性
lfte	罪行
lfud	里头
lfvg	野生
lfwd	团体
lfwh	团伙
lfxi	野心
lfxk	罪名	署名
lfxp	野外
lfxr	团队
lfxs	团结
lfyx	罪恶
lgjd	固顶
lgpg	固定
lgqu	固然	弯曲
lguo	固有
lgvz	固执
lgwd	固体
lhca	站长
lhck	站台
lhdf	站在
lhhk	站点
lhli	站立	竭力
lhne	站内
lhow	竭诚
licc	两难
lida	六大
lidl	两面
liek	六合
lifl	两地
lifn	立场
lifr	两者
liga	力度
ligd	两项	立项
ligg	林子
ligk	力强
lihj	立刻
lihk	两点
lihz	两种	六种
liie	两三
liif	立法
liip	力学
lijb	立即
lijc	两岸
likb	两只
likh	立足
lili	林立
lilj	两端
lilk	两国
lilo	两颗
lilp	两旁
lilt	力图
lilv	两边
lima	立马
limg	两眼
limm	六月
linh	畏惧
linv	两性
liog	两根
lioo	林木	力求
lioy	两样
lipn	立案
lips	两家
liqi	力气
liqv	力争
liri	力量	六日
lisi	六十
liso	两手
lisx	立志
liti	两天
lits	两条
liud	两头
liuq	两次
lius	两道
live	两会
livh	两个
liwb	两侧
liwd	立体
liwl	两位	两倍
liwv	力作
lixj	六级
liye	林业
liyo	两用
ljfl	耕地
ljgf	端庄
ljih	端正
ljko	端口
ljle	耕耘
ljvg	端午
lkai	部落	回落
lkap	国营
lkbd	部分	加分
lkca	部长	加长
lkcb	回顾
lkce	驾车	回车
lkcf	回到
lkda	加大
lkdc	加载
lkds	国泰
lkek	回合
lkfc	回去
lkff	国土
lkfg	竞猜
lkft	国旗	回放
lkga	国度
lkgd	国庆
lkgg	架子
lkgi	回应
lkgk	加强
lkgo	加工
lkhe	国税
lkhh	回收
lkhk	加点
lkhn	部委
lkho	加以
lkia	圆满
lkil	国画
lkim	回来
lkip	加深	国学
lkiy	加油
lkjc	加紧
lkjh	回帖
lkjv	回归
lkjx	贺岁
lkke	圆形
lkkj	加班
lkkk	国王
lkkv	回响
lkkw	回味
lklc	国产
lklf	部署
lklg	加固
lkli	国力	国立
lklk	回国	圆圆
lklr	回音
lkmc	驾驭	回眸
lkme	部门	国门
lkms	驾驶
lkne	国内
lkng	国情
lknh	国民
lknn	加快
lkny	回忆
lkoj	剖析	架设
lkom	回想
lkon	加之
lkoq	架构
lkos	国标
lkow	国语
lkpb	竞赛	加密
lkpg	架空
lkpk	国宝
lkps	国家	回家
lkpv	回避
lkql	加重
lkqv	竞争
lkqz	回馈
lkrd	驾照
lkre	国人
lkrm	加盟
lksa	加上
lksg	加剧
lksi	国是	回事
lksp	贺卡
lksv	加速
lksx	加息
lkte	回答	竞选
lktf	亟待
lktl	国籍
lktr	回复
lktv	加州
lkud	回头
lkum	加盖
lkuo	国有
lkus	回首	国道
lkva	回升
lkvb	回报	竞拍
lkve	国会
lkvh	国企
lkvo	加热
lkvs	竞技
lkvy	加入
lkwg	国债
lkwl	部位	加倍
lkwn	部件
lkwv	竞价
lkwy	回信
lkxf	国防
lkxp	国外
lkxr	部队
lkxs	国际
lldc	男友
ller	男儿
llgg	男子
llgh	男孩
llle	田园
lllf	田野
llnv	男女	男性
lloq	童话
llre	男人
llsi	男士
llta	童年
lltc	田径
lltj	男篮
llus	男装	童装
llvg	男生
llxi	童心
lmcd	商厦
lmfb	耗费
lmfn	商场
lmfr	商都
lmfw	商城
lmgh	商店
lmhu	商户
lmkk	商品
lmko	胃口
lmlu	商圈
lmlv	商界
lmmn	胃肠
lmng	商情
lmof	商讨	耗材
lmoh	商谈
lmoj	商机
lmos	商标
lmps	商家
lmqd	商贸
lmqf	商铺
lmqi	商丘
lmre	商人
lmrf	耗时
lmri	商量
lmte	商行
lmtl	商务
lmvb	商报
lmve	商会
lmye	商业
lmyo	商用
lnti	楚天
lobs	龙泉
locc	困难
lofl	困境
lofs	罚款
lofw	龙城
logg	果子
logk	困惑
lois	果汁
lojs	龙岩
lole	果园	困了
lomc	龙凤
lome	龙门
loml	颗粒
lomn	果断
lomu	龙腾
looc	果树
lopu	果实
loqu	果然
losh	果真
loud	龙头
lovd	困扰
lowq	龙华
lows	梦想成真
lpcm	旁观
lpkk	帝王
lplk	帝国
lplv	旁边
lpre	旁人
lqlm	麒麟
lrab	章节
lrcb	意愿
lrdf	意在
lret	韶关
lrfl	意境
lrhh	音频
lrhk	章程
lrji	意甲
lrkv	音响
lrkw	意味	韵味
lrlt	意图
lrlx	意思	音效
lrmq	意见
lrmu	意料
lrok	意识
lrol	意为
lrox	意义
lrqb	音色
lrqu	竟然
lrqx	音乐
lrri	音量
lrrs	音质
lrry	彰显
lrsi	竟是
lrsv	音速
lrsx	意志
lrto	音箱
lrtv	赣州
lrtw	音符
lruo	竟有
lrwn	意念
lrwx	音像
lrxp	意外
lsad	亲切
lsag	辛苦
lsax	禁区	新药	新区
lsce	新车
lscf	新到
lscl	亲历
lscq	新欢
lsdc	亲友
lsde	新的
lsdj	新奇
lsdr	新春
lsep	亲爱
lsfs	新款
lsfu	新增
lsgf	新疆
lsgg	亲子
lsgh	新店
lsgt	新路
lshf	新房
lshh	新颖
lshn	新秀
lshr	新旧
lshs	置疑
lshu	新科
lshz	禁止
lsif	置于
lsih	新潮
lsii	新兴
lsio	新浪
lsjd	置顶
lsjh	新帖
lsjk	新歌
lsjl	辛勤
lsjt	亲临
lsjv	亲近	新进
lskj	新型
lskk	新品
lskq	亲吻
lslh	新站
lsli	毅力
lslr	新意
lsme	新闻
lsmg	亲眼
lsmj	新股
lsng	亲情
lsnn	禁忌
lsno	新娘
lsnq	新婚
lsof	新村
lsoj	新郎	新机
lspb	亲密
lspl	新宠
lspr	新版
lsqe	新锐
lsqu	毅然
lsre	亲人	新人
lsrv	新星
lsse	置身	亲身
lsso	亲手	新手
lssu	新书
lssy	亲属
lsta	新年
lsvg	亲生	新生
lsvo	亲热
lsvp	新建
lsvq	置换
lswc	禁令
lswq	新华
lsws	亲戚
lswv	新作	新任
lswy	置信
lsxh	新编
lsyc	辛酸
lsye	置业
lsyg	新式
lsym	新高
lsyo	禁用
lsyy	新鲜
lszi	亲自	新贵
ltdp	略带
ltgc	图库
ltge	图表
ltil	图画
ltke	图形
ltmu	图腾
ltos	图标
ltpi	图片
ltpn	图案
ltqy	图解
ltry	略显
ltsi	图示
ltsu	图书
ltuo	略有
ltwd	图例
ltwe	图文
ltwx	图像
ltxq	图纸
lubu	也不
lucm	也能
ludc	圈套
ludf	也在
ludo	也太
lufl	圈地
lugg	圈子
luhk	也和
luid	也无
luij	也没
luik	也常
luim	也来
luin	也与
lujk	也可
lukl	也别
lulf	也罢
lulu	圈圈
lung	也好
lunn	也已
luog	也请
luoh	也该
luom	也想
luov	也许
lurm	也看
lusi	也是
lute	也行
lutg	也很
lutm	也算
luuo	也有
luux	也将
luve	也会
luvv	也挺
luwg	也做
luwx	也像
luxn	也要
luyo	也用
luyx	也就
lvdl	界面
lvfl	边境
lvlv	边界
lvmi	辽阔
lvpg	界定
lvpj	辽宁
lvsa	边上
lvxg	界限	界线
lvxx	边缘
lwcm	围观
lwfs	围墙
lwfw	围城
lwgt	围攻
lwji	围巾
lwoq	围棋
lwxg	围绕
lxaq	交警
lxax	郊区
lxck	逻辑
lxcm	效能
lxco	交叉
lxcy	交通
lxdc	交友
lxep	恋爱
lxfb	交费
lxff	交替
lxfg	思考
lxfl	梦境
lxgi	效应
lxgm	交融
lxgt	思路
lxhk	交战	累积
lxhu	思科
lxia	交汇
lxif	梦游
lxih	交涉
lxix	交互
lxiy	交流
lxjj	交出
lxle	累了
lxlf	梦里
lxli	效力
lxlo	效果
lxlv	交界
lxlx	累累
lxma	罗马
lxmq	梦见
lxng	恋情
lxoh	交谈
lxom	思想	梦想
lxos	累计
lxqa	交错
lxqt	交锋
lxqu	恋曲
lxre	恋人
lxrq	交易
lxsa	恋上
lxsp	思索
lxtf	交待
lxto	交往
lxub	效益
lxus	交道
lxvl	交接
lxvq	交换
lxvs	罗技
lxwc	毗邻
lxwf	交付
lxwn	思念
lxwq	交货
lxwy	交代
lxxc	思维
lxxe	交给
lxxf	思绪
lxxk	交织
lxxn	交纳
lxxo	梦幻
lxxp	郊外
lxxs	交际
lxyx	效率
lxzo	梦中
lyim	袭来
lyjb	袭击
mace	马车
madv	马达
maec	驱动
mage	马克
magn	毛孔
magt	马路
maim	马来
maji	毛巾
mali	马力
maml	朦胧
maoc	马桶
masa	马上
masv	驱逐
mauc	瞄准
maui	毛病
mawl	驱使
maxg	毛线
maxq	眼花缭乱
maye	毛衣
mbax	服药
mbbq	肥皂
mbio	粉末
mbkm	凸现
mbme	肥胖
mbmu	肥料
mbqb	粉色
mbqi	服气
mbqt	服饰
mbrr	服从
mbry	凸显
mbsy	粉碎
mbtl	服务
mbus	服装
mbwm	盼望
mbxg	粉红
mbyo	服用
mcdf	睡在
mcer	胎儿
mcip	睡觉
mclh	驿站
mclx	睡梦
mcmb	凤凰
mcmn	睡眠
mcmu	糟糕
mcsm	闽南
mctr	睡得
mcum	睡前	睡着
mcvd	骚扰
mcye	睡衣
mdce	骑车
mdkj	类型
mdkl	类别
mdma	骑马
mdmu	类目
mdqb	骑兵
mdsi	骑士
mdwh	类似
mdwm	瞭望
meai	脱落
mecf	闻到
mecl	阅历
medl	门面
megg	胖子
megl	脸庞
mehc	脸皮
mehh	验收
mehu	门户
meip	脱下
meir	门派
mejd	脸颊
mejt	阅览
meko	门口
melk	脸部
mels	门禁
memr	瞬间
menh	脸蛋
meoi	验证
meoj	门槛
meoo	阐述
meos	阅读
meov	门诊
mepv	门窗
meqb	脸色
mequ	骤然
mesa	脸上
mesu	脱水
meum	门前
meux	门将
mevh	脱掉
mewb	脱离	脱俗
mexg	脸红
mexk	闻名
mexp	门外
mexs	门票
meye	脱衣
meyj	门市
mfbc	周公
mfcf	周到	周转
mfcr	周遭
mfds	脚本
mfer	周二
mffl	墓地
mfft	周旋
mfgg	肚子
mfgj	周刊
mfhc	肚皮
mfhh	脚步
mfhj	雕刻
mfie	周三
mfig	肤浅
mfii	周一
mfio	周末
mfip	脚下
mfjx	周岁
mfko	周口
mfle	周四
mfli	周六
mflv	周边
mflw	周围
mfmc	瞌睡
mfmj	闭幕
mfpb	周密
mfqb	肤色
mfqi	脚印
mfqm	周期
mfri	周日
mfrq	周易
mfsa	闭上
mfta	周年
mfum	雕塑
mfvb	周报
mfwu	周五
mfwx	雕像
mgay	精英
mgcf	精致
mgcw	同龄
mgcy	精通
mgdf	同在
mgeo	精彩
mgfw	同城
mgga	精度
mggg	精巧	精子
mggo	精工
mggq	眼底
mghc	眼皮
mghh	同步	肝炎
mghr	同桌
mghu	眼科
mgii	同一
mgim	眼泪
mgip	同学	眼下
mgiq	精湛
mgiv	糊涂
mgiw	眼光	同济
mgiy	精油
mgkj	同班
mgkk	精品
mgko	眼球
mglf	眼里
mgli	精力
mglk	眼部
mglo	糖果
mglr	同意
mglu	眼圈
mglv	眼界
mgma	眼眶
mgmd	同类
mgmg	眼睛	肝脏
mgmm	精髓
mgmq	眼见	同胞
mgmy	精粹
mgng	同情
mgnv	同性
mgog	精良
mgol	同为
mgow	精诚
mgoy	同样
mgpb	精密
mgpj	眼帘
mgps	精神	眼神
mgpv	同窗
mgql	眼镜
mgqm	同期
mgqy	眼角
mgrf	同时
mgrm	眼看	精明	同盟
mgsa	同上
mgsg	同居
mgsi	同事
mgsq	精确
mgsx	同志
mgta	同年
mgte	同行	精选
mgtf	同等
mgtj	精制
mgtm	精简
mguc	精准
mgud	精美
mgui	肝病
mgum	眼前
mgus	精装
mgvh	精灵
mgwe	同伴	同仁
mgwg	同感
mgwq	精华
mgxh	同比
mgxi	精心	同心
mgxj	同级
mgxk	同名
mgxl	精细
mgxv	同乡
mgye	同业
mgzo	眼中
mhbh	粘贴
mhgg	骗子
mhmf	脂肪
mhre	骗人
mhsn	骗局
mifb	免费
mifc	免去
migb	免责
mihh	肺炎
mitr	免得
miuj	免疫
mixv	免除
mjax	股东
mjds	股本
mjfs	幕墙
mjmf	肌肤
mjnh	股民
mjnr	肌肉
mjoc	股权
mjrg	幕后
mjum	盯着
mjvh	股指
mjwb	股份
mjxs	股票
mjyj	股市
mkan	问世
mkax	问药
mkcf	问到
mkji	问及
mkkg	问号
mkng	问好
mksd	问题
mkte	问答
mkub	问卷
mkus	问道
mkwh	问候
mkzn	问起
mlco	募集
mlgg	粒子
mlgk	勉强
mliz	胶囊
mlmh	胶粘
mlmy	驰骋
mlpi	胶片
mlxk	驰名
mmal	月薪
mmcl	月历
mmdc	朋友
mmga	骨干
mmgj	月刊
mmgq	月底
mmip	月下
mmiw	月光
mmjv	闯进
mmko	月球
mmlk	月圆
mmmm	骷髅	骨髓	骨骼
mmne	月内
mmpd	月初
mmqb	月色
mmqe	月饼
mmqu	蓦然
mmud	骨头
mmum	月前
mmvj	骨折
mmvy	闯入
mmwb	月份
mmxc	月经
mmyp	月亮
mmyw	月夜
mndi	断电
mndj	断裂
mndr	数百
mnhk	断点
mnip	数学
mnlm	肠胃
mnmu	数目
mnpg	数字	断定
mnpt	数额
mnqi	数千
mnri	数量
mnsi	数十
mnsm	数码
mnta	数年
mnuq	数次
mnvp	数控
mnvs	数据
mnwa	数万
mnwl	数位
mnws	数值
moda	莫大
moeq	闲聊
mofe	莫非
mogg	兔子
moib	莫测
moiy	粮油
mokh	驻足
mols	闲置
mooq	闲话
morn	闲暇
moum	膝盖
mouz	脉冲
movf	脉搏
mowg	粮食
moxk	莫名
mpig	风平浪静
mple	瞎了
mqcf	见到
mqda	睁大
mqdl	见面
mqfo	见过
mqgu	脆弱
mqka	睁开
mqko	胸口
mqlh	胸罩
mqlk	胸部
mqlx	见效
mqme	见闻
mqmi	胸膛
mqnb	胸怀
mqoi	见证
mqok	见识
mqoy	见谅
mqqy	见解
mqtr	见得
mqum	胸前
mqxi	见习
mrdg	闪存
mrdi	闪电
mrfo	闪过
mrgg	胆子
mrhq	闪烁
mriw	闪耀	闪光
mrmn	间断
mrmr	闪闪
mroa	间谍
mrpt	闪客
mrqi	脾气
mrvl	间接
mrxg	间隔
mrxi	胆小
mrxx	间隙
mryp	闪亮
msgg	脖子
msmu	瞩目
mswd	肢体
mtip	阁下	腹泻
mtlk	腹部
mtmf	胳膊
mtmp	骆驼
mubb	母婴
mucf	料到
mude	目的
mugg	母子
muiw	目光
mujb	目击
mukl	料理
muls	母亲
mumf	目睹
munn	腾飞
munv	母女
muol	母校
muom	精益求精
muon	腾讯
muos	目标
muum	目前
muvs	目录
mvai	迷茫
mvfl	胜地
mvfo	胜过
mvgk	迷惑
mvgt	迷路
mvhj	胜利
mvif	胜于
mvjj	胜出
mvlx	迷恋
mvma	睫毛
mvmg	眨眼	迷糊
mvnm	迷惘
mvpk	迷宫
mvqb	胜负
mvre	迷人
mvvf	迷失
mvwa	骄傲
mvwb	迷离
mvwq	迷你
mvwv	胜任
mvwy	迷信
mvyt	迷雾
mwgg	脑子
mwit	脑海
mwme	阀门
mwtm	脑筋
mwwy	脑袋
mxai	风范
mxcy	网通
mxdb	网页
mxdc	网友
mxdp	腰带
mxeb	风貌
mxec	风云
mxeo	风采
mxet	网关
mxfh	网址
mxfv	刚才
mxga	风度
mxgl	风靡
mxhk	网点
mxhx	风扇
mxih	风波	风潮
mxim	风尚	刚来
mxir	风湿
mxiw	风光
mxiy	风流
mxkb	网吧
mxko	网球
mxkq	风吹
mxkw	风味
mxlf	风里
mxlh	网站
mxlr	风韵
mxlx	网恋
mxmc	膨胀	风骚
mxmm	风月
mxmx	刚刚
mxne	网内
mxng	刚好	风情
mxnh	网民
mxol	网校
mxot	风格
mxqi	风气
mxqn	莫名其妙
mxqs	腰包
mxqw	风铃
mxra	风暴
mxrq	网易
mxry	风景
mxsa	网上
mxsn	风声
mxsp	网卡
mxsu	风水
mxsv	网速
mxte	风行
mxtp	网管
mxud	风头
mxvm	风向
mxwb	风俗
mxxe	风险
mxxf	风尘
mxxk	网名
mxxs	网际
mxxt	网络
mxyo	风霜
mxyu	风雨
mxyv	风雪
mxze	风趣
mxzo	风中
myax	丹东
mygt	丹麦
mymg	肮脏
myoo	糯米
myqz	闹钟
mzuq	肿瘤
mzwm	眺望
nalr	惬意
naqk	慌乱
nasi	懂事
natr	懂得
nbhr	怀旧
nbhs	怀疑
nblf	怀里
nbnv	怀孕
nbum	怀着
nbvq	怀抱
nbwn	怀念
nbzl	情不自禁
nbzo	怀中
ncbt	惨败
nccr	惨遭
ncdj	惨烈
ncel	怪兽
nchu	怒火
ncif	始于
ncii	惟一
ncjo	怒斥
ncle	惨了
ncli	努力
ncnc	怪怪
ncng	惭愧
ncnq	怪物
ncny	憔悴
ncql	惨重
ncsa	怪异
ncsi	怪事
ncvp	始建
ncvs	奴隶
ncxt	始终
ndhh	忧愁
ndhx	忧虑
ndtr	恢复
ndux	忧郁
ndwt	忧伤
neap	内蒙
nedf	内在
nedg	内存
neer	悦耳
nefl	内地
nehu	内科
neib	内测
neif	敢于
nein	内涵
neiv	恰当
nelk	内部
nels	内置
nemj	内幕
nene	恰恰	愉悦
neng	恰好
nenn	愉快
neoe	敢说
neoh	内核
nepg	内裤
nepv	内容
nesi	恰是
neuq	内疚
nevm	内向
newn	内含
nexi	内心
nexj	内陆
nexp	内外
neye	内衣
nfax	特区
nfbf	特邀
nfca	特长
nfck	特辑
nfda	特大
nfdv	特殊
nffl	特地
nfgj	特刊
nfgo	特工
nfhh	特此
nfhk	特点
nfhz	特种
nfkl	特别
nflc	特产
nflr	特意
nflx	特效
nfme	丑闻
nfmy	牡丹
nfnf	娃娃
nfnn	特快
nfnv	特性
nfoc	特权
nfov	特许
nfpg	特定
nfpi	特写
nfqb	特色
nfrs	特质
nfsn	特卖
nfsr	妨碍
nfti	特征
nftj	特制
nfuo	特有
nfvs	特技
nfwv	特价
nfxi	丑陋
nfxj	特级
nfxq	特约
ngab	情节
ngbu	好不
ngbv	情欲
ngca	司长
ngcb	情愿
ngcc	好难
ngcf	好转
ngcg	好戏
ngda	好歹	好大
ngdc	好友
ngde	好的
ngdf	好在
ngdj	好奇
ngec	好运
ngep	情爱
ngfb	好坏
ngfl	情境
ngfo	好过
nghh	好些
ngic	好汉
ngif	司法
ngip	好学
ngji	好几
ngjk	情歌
ngke	情形	好玩
ngkj	好听
ngkl	情理
ngkm	好吗
ngkt	好吃
ngkx	好啊
ngky	好呀
ngle	好了
nglr	情意
nglx	好累
ngma	司马
ngmv	情迷
ngmx	情网
ngnb	情怀
ngng	好好
ngnj	慷慨
ngno	姑娘
ngoe	好说
ngoj	司机
ngom	情调	好想
ngon	惦记
ngop	好评	情谊
ngoq	情话
ngos	好让
ngqb	好色	情色
ngqy	好久
ngre	情人	好人
ngrm	好看
ngry	情景
ngsi	好事
ngsu	情书	好书
ngtp	好处
ngtv	好笑
ngud	好美
nguk	情况
ngvb	情报
ngvj	媒介
ngwc	司令
ngwd	媒体
ngwg	情感	好感
ngwh	好似
ngwk	情侣
ngwx	好像
ngxf	情绪
ngxh	好比
ngxi	好心
ngxs	情结
ngxx	好多	情缘
ngyo	好用
ngze	情趣
nhap	民营
nhaq	民警
nhba	蛋白
nhcm	改观
nhec	改动
nhee	疏远
nhft	民族
nhge	改革
nhgo	民工
nhif	民法
nhih	民政	改正
nhjk	民歌
nhjv	改进
nhlb	民办
nhlc	改变
nhlk	民国
nhlr	民意
nhmr	民间
nhmu	蛋糕
nhna	如火如荼
nhnb	惧怕
nhoe	民谣
nhog	改良
nhok	民主
nhol	改为
nhpi	改写
nhpr	改版
nhqr	疏忽
nhsi	民事
nhti	改天
nhtj	改制
nhtk	改造
nhus	改装
nhvg	民生
nhvh	民企
nhvp	改建
nhvr	民众
nhwb	民俗
nhwn	悼念	改成
nhxh	改编
nhxi	民心
nhxk	改名
nhyo	民用	改用
nhyu	改善
nhzy	民航
nier	鸟儿
nihc	牛皮
niiv	牛津
nini	悄悄
ninn	牛奶	妩媚
ninq	恍惚
ninr	牛肉
ninw	嫦娥
niqu	悄然	恍然
niwg	牛仔
niyj	牛市
niyk	牛群
njhs	嫌疑
njji	岛屿
njsa	岛上
nkaw	如花
nkbu	如不
nkcb	如愿
nkec	如云
nkhh	如此
nkhl	如烟
nkii	如一
nkil	如画
nkip	如下
nklo	如果
nklr	如意
nklt	如图
nklx	如梦
nkmg	如同
nkpu	如实
nkqm	如期
nkqx	娱乐
nksi	如是
nksu	如水
nkuo	如有
nkwj	如何
nkwn	如今
nkyd	如需
nlnr	憧憬
nlnv	惯性
nlps	她家
nlwd	惯例
nlwm	她们
nlxx	姻缘
nmde	妈的
nmkm	妈咪
nmma	眉毛
nmnc	惆怅
nmnm	妈妈
nmud	眉头
nnav	奶茶
nnce	快车	飞车
nncf	快到
nndf	已在
nnds	飞奔
nndv	已达
nnex	快递
nnfc	快去	飞去
nnfo	飞过	已过
nngv	飞跃
nnhk	快点
nnhx	快餐
nnim	快来
nniq	快活
nniy	奶油
nnle	快了
nnlo	飞龙
nnmb	奶粉
nnme	快门
nnni	飞鸟	奶牛
nnnn	奶奶	飞快
nnnq	已婚
nnoj	飞机
nnom	遐想
nnon	快讯
nnqq	快快乐乐
nnqu	已然
nnqx	快乐
nnqy	已久
nnsk	已知
nnsv	快速	飞速
nntd	飞舞
nnte	飞行
nnti	飞天
nnto	飞往
nnuo	已有
nnux	飞翔	已将
nnvb	快报
nnvm	飞向
nnvn	飞扬
nnvv	快捷
nnwg	快感
nnxc	已经
nnxn	快要
nnzh	飞越
nnzj	飞船
nogg	娘子
npna	惋惜
npxe	嫁给
nqdn	恍然大悟
nqex	姐弟
nqgd	婚庆
nqhz	物种
nqiy	物流
nqkk	物品
nqkl	物理
nqlx	婚恋
nqmu	物料
nqnl	婚姻
nqnq	姐姐
nqnt	忏悔
nqnw	姐妹
nqow	物语
nqpn	婚礼
nqrg	婚后
nqrs	物质
nqum	婚前
nquq	物资
nqvj	婚介
nqwd	物体
nqwn	物件
nqwv	物价
nqxx	婚纱
nqye	物业
nrgl	肉麻
nrmd	肉类
nrnr	慢慢
nrnv	慢性
nrwd	肉体
nsdc	承载
nsep	承受
nsfg	迅猛
nslb	承办
nsmn	函数
nsnc	愤怒
nsnd	懒惰
nsnv	媳妇	妓女
nsoa	承诺
nsor	承认
nsql	慎重
nsqs	承包
nssv	迅速
nstr	懒得
nsts	承德
nsvl	承接
nsvr	承担
nsyl	迅雷
nsyo	慎用
ntfn	牧场
ntji	牧师
ntng	悔恨
ntya	牧羊
ntye	牧业
nuae	买菜
nucf	买到
nuel	买单
nuhk	买点
nuim	买来
nuip	买下
nule	买了
nunh	嫉妒
nups	买家
nusn	买卖
nuvy	买入
nuxs	买票
nvbv	性欲
nvcf	乃至
nvcm	性能
nvdc	女友
nvde	女的
nvee	妇联
nvek	性命
nvep	性爱
nver	女儿
nvfq	娇艳	妖艳
nvgg	女子	性子
nvgh	女孩
nvhj	盈利
nvhu	妇科
nvkh	女足
nvkk	女王
nvkl	性别
nvlx	性交
nvmg	妖精
nvnc	妊娠
nvng	性情	妖娆
nvnv	女性	妇女	孕妇
nvoj	女郎
nvot	性格
nvps	女神
nvqa	姓氏
nvre	女人	妇人
nvrs	性质
nvrv	女星
nvsi	女士
nvsn	女声
nvud	媲美
nvui	性病
nvus	女装
nvvg	女生
nvwd	女优
nvwg	性感
nvxi	娇小
nvxk	姓名
nvxo	妇幼
nvym	孕育
nwep	怜爱
nwif	忙于
nwnm	怜悯
nwnw	妹妹
nwpg	悟空
nwsv	忙碌
nxbv	那还
nxcg	嬉戏
nxdj	那段
nxer	那儿
nxgc	那张
nxhh	那些
nxhz	那种
nxjk	那可
nxkb	那只
nxlf	那里
nxlv	那边
nxnv	牺牲
nxnw	姊妹
nxoy	那样
nxpi	那片
nxps	那家
nxqk	那句
nxrf	那时
nxta	那年
nxti	那天
nxts	那条
nxud	那头
nxuq	那次
nxvc	那么
nxvh	那个
nxwb	那份
nxwn	那件
nxyx	那就
nydj	惊奇
nyec	惊动
nyfq	惊艳
nygj	惊恐
nygu	懦弱
nykc	惊叹
nykh	惊呼
nyna	惊慌
nyoy	惊讶
nyre	惊人
nysa	惊异
nyxe	惊险
nyxk	惊喜
nyyr	惊醒
nzrm	姚明
oack	柜台
oalk	框架
oate	横行
oavm	横向
oavv	横扫
oaxn	枢纽
oayk	诺言	谎言
obaw	棉花	樱花
obgg	杯子
obgl	松弛
obig	松江
obip	松下
obka	松开
obli	柏林
oboz	樱桃
ocbu	谁不
ocde	谁的
ocfr	译者	谁都
ochj	权利
ocip	树下
ocks	树叶
ocli	权力	树林	树立
oclu	谁也
ocmh	树脂
ocne	谁敢
ocoa	橱柜
ocoo	树木
ocos	树枝
ocps	谁家
ocpv	橱窗
ocsa	树上
ocsk	谁知
ocub	权益
ocwi	权威
ocxg	权限
odgg	椅子
odko	棒球
oecf	说到
oefo	说过
oehh	说些
oeib	检测
oeif	说法
oeii	检举
oeim	说来
oejj	说出
oekb	说吧
oemb	说服
oeme	检验
oeng	说好
oeoa	说谎
oeoe	说说
oeof	检讨
oeoq	说话
oeor	检查
oepe	说完
oepm	检视
oepw	检察
oerm	说明
oesp	检索
oeuj	检疫
oeum	说着
oeus	说道
oewh	检修
oewn	说成
oeyk	谣言
oezn	说起
ofaw	桂花
ofco	诗集
ofcq	讨厌
ofgf	村庄
ofgg	村子
ofjk	诗歌
ofkm	杜鹃
oflf	村里
ofli	桂林
oflr	诗意
ofmk	访问
ofmu	材料
ofng	讨好
ofnh	村民
ofnk	诸如
ofoh	访谈
ofol	诽谤
ofon	诗词
ofov	讨论
ofpe	桂冠
ofpt	访客
ofre	诗人
ofrs	材质
ofwl	诸位
ofwn	诸侯
ofwq	访华
ofxq	杜绝
ofxx	诸多
ogah	枯萎
ogba	李白
ogcf	请到
ogds	根本
ogfg	请教
oghk	枯燥
oghz	良种
ogic	根源	根治
ogim	请来
ogjt	概览
ogjv	请进
ogmk	请问
ogng	良好
ognv	良性
ogoj	良机
ogoo	请求	谋求	概述
ogov	概论
ogpt	请客
ogqf	根基
ogqr	请勿
ogqy	良久
ogrm	请看
oguk	概况
ogvm	请向
ogvq	概括
ogvs	根据
ogwn	概念	请假
ogwq	请您
ogxi	良心
ogxn	概要
ogxs	谋杀
ogxx	请多
ogyo	请用
ogyx	概率
ohcf	核对	谈到
ohdh	该死
ohej	谈判
ohfc	诱发
ohgd	该项
ohgk	诱惑
ohji	谈及
ohoh	谈谈
ohoq	谈话
ohov	谈论
ohoz	核桃
ohpu	核实
ohre	诱人
ohsf	诱导
ohtm	核算
ohuc	核准
ohxi	核心	谈心
ohzn	谈起
oihi	相濡以沫
oipn	档案
oipu	证实
oirm	证明
oisu	证书
oiud	证券
oiuq	档次
oivs	证据
oiwn	证件
ojbq	订购
ojbu	极不
ojce	机车
ojcf	极致	讲到
ojcm	机能
ojda	极大
ojdi	机电
ojdv	柯达
ojec	机动
ojel	订单
ojet	机关
ojfe	讲坛
ojfn	机场
ojfo	讲过
ojft	设施
ojga	极度
ojgg	机子
ojgk	极强
ojgo	机床
ojgr	讲座
ojhb	极具
ojhf	机房
ojhk	极点
ojhy	谦虚
ojif	设法
ojji	讲师
ojkj	机型
ojkk	极品
ojkl	机理
ojkq	机器
ojle	极了
ojli	设立	极力	订立
ojlj	极端
ojls	设置
ojme	订阅
ojng	极好
ojns	谨慎
ojob	诉讼
ojoe	诉说
ojog	机械
ojol	极为	讲课	设为
ojom	设想
ojoo	讲述
ojoq	机构	讲话
ojos	设计	朗读
ojox	讲义
ojpb	机密
ojpg	极富	设定
ojpj	讲究
ojqi	极其
ojqy	讲解
ojrq	极易
ojsa	机上
ojse	机身
ojsk	机智
ojsm	柯南
ojsv	极速
ojtj	机制
ojtl	设备
ojto	机箱
ojuo	设有	极有
ojve	机会	讲授
ojwd	机体
ojwf	极佳
ojwg	订做
ojwq	订货
ojxf	谨防
ojxg	极限
ojxl	训练
ojxq	机组
ojxs	机票	订票
ojxv	极少
ojym	极高
ojyv	机遇
okap	主营
okax	误区
okcm	主观
okdb	主页
okec	主动
okfn	主场
okga	主席	主干
okgc	主张
okhr	主旨
okic	主治
okip	主演
okiy	主流
okjj	主帅
okkl	识别
okkr	主唱
oklb	主办
okle	误了
okli	主力
oklr	主意
oknv	主妇
okoc	主权
okoj	主机	主讲
okor	主板
okox	主义
okpg	识字
okpl	主宰
okqy	主角	误解
okre	主人
oksd	主题
oksf	主导	误导
oktp	主管
okug	误差
okve	误会
okvf	主持
okvj	主打
okwd	主体
okwv	主任
okxg	主线
okxh	主编
okxn	主要
okxr	主队
okye	主业
olax	校区
olca	校长
olcc	为难
oldc	校友
olde	为的
olds	课本	为本
olfe	为非
olgd	校庆
olhh	为此
olhk	课程
olhz	为止
olik	课堂
olkk	为王
olkv	为啥
olle	为了	校园
olli	森林
olme	校门	校验
olmn	为数
olne	校内
olnh	为民
olok	为主
olon	为之
oloy	榜样
olpq	为宜
olql	为重
olqm	为期
olre	为人
olrf	课时	为时
olsd	课题
oluc	为准
olus	为首	榜首
olvg	为生
olwd	为例
olwe	课文
olwj	为何
olwn	课件
olwo	为我
olxk	为名
olxp	课外	校外
olyo	为由
omab	调节
omai	模范
ombi	想必
omce	相册
omcf	想到	相对	调到
omcv	相连
omcy	相通
omeb	相貌
omec	调动	相聚
omep	相爱
omet	相关
omfn	模块
omfo	想过
omga	调度	相距	相干
omgi	相应
omhb	模具
omhc	调皮
omhf	楼房
omhh	调频
omif	想法
omim	想来
omip	楼下
omiv	相当
omix	相互
omjj	讽刺	想出
omjv	相近
omkj	模型
omkl	调理
omks	枫叶
omkw	调味
omls	相亲
omlx	相思	相交	相恋
ommg	相同	模糊
ommk	想问
ommq	相见
omnf	模特
omng	调情
omoa	相框
omoe	楼梯	想说
omoj	相机
omok	相识	楼主
omom	想想
omor	调查	模板
omoy	模样	调试
ompf	相守
ompi	相片	楼宇
omql	相助
omqy	调解
omrc	相反
omsa	楼上
omse	楼层
omsk	调研	相知
omsn	相声
omst	调整
omtf	相逢
omtj	调制
omtp	相处
omtw	相符
omug	相差
omve	相会
omvg	想找
omvh	模拟
omvl	相撞
omvp	调控
omvy	相拥
omwc	相邻
omwe	相伴
omwf	模仿	相传
omwg	想做
omwh	相似
omwj	调剂
omwk	调侃
omwn	想念
omwx	想像
omwy	相信
omxg	相隔
omxh	相比
omxi	想象
omxm	相继
omxn	想要
omxq	相约
omxu	相随
omyg	模式
omyj	楼市
omyn	调配
omyo	调用
omyv	相遇
omzm	楼盘
omzn	想起
onbd	之分
onbx	之父
ondb	词典
ondc	记载
ondj	之列
onds	之本
oner	之二
onfc	之辈
onfl	之地
onfr	记者
onft	之旅
ongc	词库
ongt	之路
onhk	之战
onhm	诸如此类
onhq	之称
onia	词汇
onic	之源
onie	之三
onii	之一	之举
onip	之下	记下
oniw	之光
onjk	之歌
onli	之力
onmd	之类
onme	之门
onmr	之间
onne	之内
onng	之情
onnj	之嫌
onnq	之物
onny	记忆
onoe	谈情说爱
onoj	橄榄	之极
onom	之谜
onon	札记
onoq	杨柳
onow	词语
onpd	之初
onpg	诀窍
onps	之家	之神
onpv	之窗
onqv	之争
onre	之最
onrf	之时
onrg	之后
onri	之日
onrv	之星
onsa	之上
onsi	之事
onsn	之声
onsx	讯息
onte	之行
ontp	之处
ontr	记得
onum	之前
onus	之道	之首
onvl	之势
onvs	记录
onvy	之余
onwo	记住
onxi	之心
onxk	之名
onxp	之外
onxq	词组	之约
onxs	之际
onxv	之乡
onyo	之用
onyw	之夜
onzn	记起
onzo	之中
ooas	求医
oobq	求购
ooek	救命	求职
ooep	求爱
ooge	杰克
oogo	木工
ooic	救治
ooip	求学
ooiw	救济
oojj	杰出
ookb	议员
ooma	木马
oonq	求婚
ooof	木材
oooo	求救
ooor	木板
ooov	议论
ooow	术语
oopn	议案
oopu	求实
ooql	救助	求助
ooqr	米饭
oore	救人
oors	木质
oosd	议题
oosi	议事
oosk	求知
ootr	求得
ooud	木头
ooue	米兰
oove	议会	救援
oovh	救护
oowv	杰作
opbd	评分
opej	评判
opgx	朴素
ophn	评委
opib	评测
opjj	评出
opoa	柠檬
opoc	榕树
opoe	评说
opoj	评析
opol	评为
opoo	评议	评述
opov	评论
opow	评语
oppg	评定
opps	评审
oppu	朴实
opqb	棕色
opsa	诧异
opte	评选
opud	枕头
opwg	评估
opwv	评价
opxh	评比
opxj	评级
oqfb	话费
oqgg	棋子
oqkj	诅咒
oqlr	话音
oqlt	构图
oqlx	构思
oqmk	询问
oqoe	话说
oqom	构想
oqow	话语
oqsa	诡异
oqsd	话题
oqsg	话剧
oqtg	构筑
oqtk	构造
oqtm	话筒
oqtv	柳州
oqvp	构建
oqwn	构成	构件
orbq	认购
orcf	查到
orfn	板块
orig	认清
orjj	认出	查出
orjk	认可
orme	查阅
ormg	认同
orof	板材
oroi	认证
orok	认识
orol	认为
oroq	查询
orov	板桥
orpg	认定
orqa	认错
orrm	查看	查明
orsh	认真
orsk	认知
ortp	查处
ortr	认得
orvg	查找
orwg	板凳
orxs	查杀
oryg	板式
osbu	永不
oscf	标致
oscl	计较
osde	标的
osds	标本
osec	读取
osee	永远
osfb	计费
osfo	读过
osfr	读者
osgo	计划
oshh	让步
osio	标注
osmn	计数
osna	读懂
osni	永恒
osnq	植物	读物
osoc	植树
osok	标识
oson	标记
osos	谢谢
osow	标语
ospe	读完
osph	让它
ospi	读写
ospn	永安
ospr	标牌
osqx	永乐
osqy	永久
osre	让人
osrf	计时
osri	计量
osrm	标明
ossd	标题
ossi	标示
ossp	读卡
ossu	读书
ossx	标志
oste	标签
ostm	计算
osuc	标准
osvg	计生	永生
oswl	让他
oswo	让我
oswq	让你
oswv	标价	计价
osxq	谢绝
otaw	梅花
otgg	格子
otli	格林
otom	格调
otot	格格
otsn	格局
ottv	梅州
otus	格斗
otxp	格外
otyg	格式
otyk	格言
oumu	栏目
ouog	栏杆
ovcb	许愿
ovce	诞辰
ovfe	论坛
ovic	诊治
ovid	桥梁
ovit	株洲
ovjb	枪击
ovjk	许可
ovmh	诈骗
ovmn	诊断
ovoa	许诺
ovoi	论证
ovoo	论述
ovqy	许久
ovrn	诊所
ovrr	许昌
ovso	枪手
ovul	诊疗
ovvg	诞生
ovvm	诠释
ovwe	论文
ovxx	许多
owbf	诚邀
owbw	讨价还价
owey	诚聘
owgx	诚恳
owhz	语种
owif	语法
owlr	语音	诚意
owom	语调	梧桐
owpu	诚实
owqb	橙色
owqi	语气
owqk	语句
owti	诚征
owvs	诚挚	语录
owwe	语文
owwy	诚信
owxi	诚心
owyk	语言
oxhc	橡皮
oxlk	椭圆
oxml	橡胶
oxqi	义气
oxqn	义乌
oxsx	栖息
oxtl	义务
oxva	攀升
oxwg	攀登
oyce	试车
oyds	样本
oygg	样子	橘子
oyhk	试点
oykj	试听
oykk	样品
oykl	梳理
oylk	试驾
oylt	试图
oyme	试验
oymq	详见
oyng	详情
oyom	试想
oyor	样板
oyoy	试试
oyqy	谅解	详解
oysd	试题
oysy	详尽
oyte	试行
oytv	杭州
oyub	试卷
oyvp	试探
oywj	试剂
oyxl	详细
oyyg	样式
oyyo	试用
ozaw	桃花
ozgb	谴责
ozic	桃源
ozle	桃园
pada	宽大
padp	宽带
paga	宽度
pagu	宽广
pahh	宽频
paim	宽敞
pami	宽阔
paob	宽松
papv	宽容
pbad	密切
pbax	赛区
pbce	赛车
pbco	密集
pbct	蜜蜂
pbff	密封
pbfn	赛场
pbga	密度
pbhg	赛季
pbhk	赛程
pbma	赛马
pbmm	蜜月
pbmq	罕见
pbrg	赛后
pbsi	赛事
pbsm	密码
pbum	赛前
pcap	军营
pcax	军区
pcdc	室友
pcfa	军方
pclf	军团
pcne	室内
pcoj	军训
pcpn	军官
pcre	军人
pcsi	军事
pcsx	窒息
pcxp	室外
pcxr	军队
pcyo	军用
pdbm	视而不见
pdcm	宏观
pdda	宏大
pdhh	初步
pdii	初一
pdip	初学
pdjj	寄出
pdlx	初恋
pdmq	初见
pdnc	初始
pdow	寄语
pdqm	初期
pdtk	祷告
pduq	初次
pdvg	寄生
pdvv	寄托
pdww	宏伟
pdxe	寄给
pdxj	初级
pdyz	初衷
pdzo	初中
peax	农药
pecl	农历
pefn	农场
pefu	农夫
pego	完工
pehu	农户
pele	完了
peli	农林
pell	农田
peng	完好
penh	农民
peof	农村
peoj	农机
pepc	冠军
peps	农家
peqd	农贸
pest	完整
pete	农行
petl	完备
peud	完美
peuq	农资
pevk	完全
pewn	完成
pexh	完毕
pexs	完结
peye	农业
peyu	完善
pfax	社区
pfbi	守卫
pfbj	守则
pfcc	壁垒
pfdv	豁达
pfif	守法
pfil	壁画
pfjv	塞进
pflf	社团
pflx	社交
pfnb	害怕
pfpe	衬衫
pfre	害人
pftr	害得
pfun	害羞
pfve	社会
pfvf	壁挂
pfvh	守护
pfvv	衬托
pfwh	守候
pfwk	社保
pfwm	守望
pfwy	守信
pfxq	壁纸
pfye	衬衣
pfyk	社群
pgab	字节
pgba	空白
pgbc	富翁
pgdb	字典
pgdj	字段
pgfl	空地
pgfn	空缺
pggg	裤子
pggv	富康
pghj	福利
pghk	定点
pghy	空虚
pgif	富于	定于
pgil	字画
pgim	空洞
pgip	定下
pgkg	字号
pgkj	定型
pglf	定罪
pgll	福田
pglr	福音
pgme	窍门
pgmg	字眼
pgmj	字幕
pgmn	字数
pgmo	空闲
pgmr	空间
pgmu	字母
pgnq	空姐
pgnv	定性
pgog	字根
pgom	空调
pgot	空格	定格
pgox	定义
pgoy	字样
pgpb	富裕
pgpc	空军
pgpt	定额
pgqb	褪色
pgqi	空气	福气
pgqm	定期
pgre	富人
pgrf	定时
pgrg	空旷
pgri	定量
pgsg	定居
pgsi	富士
pgtj	定制
pgtv	福州	定律
pgtw	字符
pgum	空前
pguo	富有
pgvm	定向
pgvp	福建
pgwd	字体
pgwg	定做
pgwl	定位
pgwv	定价
pgxi	空心
pgyp	富豪
pgzi	富贵
pgzo	空中
phbv	被迫
phcc	灾难
phde	它的
phec	被动
phep	被爱
phlo	被罚
phpf	灾害
phqb	褐色
phrn	它所
phtk	被告
phvf	被捕
phwm	它们
phxs	被杀
picb	平原
picf	写到
pick	平台
pidf	写在
pidj	宣布	片段
pidl	平面	片面
piej	宣判
pifa	平方
pifl	平地
pifo	写过
pifq	平均
pifr	平坦
pigg	袜子	片子
pigm	平静
pigv	平庸
pihj	片刻
pihk	平和
pihq	平稳	宣称
piia	宣泄
piih	平淡
piik	平常
piim	平滑
piip	写下
pijj	写出
pijo	平凡
pimn	片断
ping	写好
pinh	平民
pioo	平米
pior	平板
pipe	写完
pipg	写字
pipi	平平
pipn	平安
pipu	写实
pipy	宇宙
pird	写照
pirf	平时
piri	平日
pisa	写上
pish	写真
pist	平整
pisx	平息
pite	平行
pitf	平等
pitk	宣告
pitq	平衡
piud	片头
pius	写道
pivg	平生
pivn	宣扬
pivy	写入
piwf	宣传
piwn	写成
piwv	写作	平价
piwy	写信
pixe	写给
piyk	宣言
pizy	宇航
pjcb	宁愿
pjdm	宁夏
pjgm	宁静
pjih	宁波
pjjk	宁可
pjlr	究竟
pjoo	祈求
pjpd	祈祷
pkan	宝藏
pkbe	宝贝
pkcb	祝愿
pkcn	宝鸡
pkdb	宝典
pkei	宝剑
pkgc	宝库
pkgr	宝座
pkje	宝山
pklk	祝贺
pkma	宝马
pkpg	祝福
pkpk	宝宝
pkqm	宝钢
pksa	宫殿
pksi	宝石
pkvs	宫廷
pkzi	宝贵
plep	宠爱
pler	宠儿
plnq	宠物
plrd	裸照
plre	穷人
plwd	裸体
plyg	裸露
pmhh	视频
pmhk	视点
pmip	视觉
pmkj	视听
pmlf	视野
pmli	视力
pmlt	视图
pmlv	视界
pmok	冤枉
pmol	视为
pmps	冤家
pmpw	视察
pmqy	视角
pmxg	视线
pneb	礼貌
pnfa	官方
pnfn	官场
pngd	安庆
pngm	安静
pngv	安康
pnhq	安稳
pnik	礼堂
pnkb	官员
pnkk	礼品
pnlg	牢固
pnls	安置
pnmb	礼服
pnmc	牢骚
pnmo	安逸
pnng	官司
pnnn	安娜
pnnq	礼物
pnns	安妮
pnon	牢记
pnpg	安定
pnpj	安宁
pnpn	牢牢
pnps	安家
pnqb	官兵
pnqu	安然
pnqx	安乐
pnri	礼拜
pnsg	安居
pnss	安慰
pntj	安徽
pnus	安装
pnvf	安排
pnvi	安抚
pnvk	安全
pnwd	案例
pnwn	案件
pnwo	礼仪
pnxi	安心
pnxr	安阳
powy	宋代
ppbh	补贴
ppjj	补丁
ppoo	补救
ppql	补助
ppwi	补偿
ppxi	补习
ppye	补充
pqfc	突发
pqii	宜兴
pqjb	突击
pqjj	突出
pqlc	突变
pqlk	祖国
pqlw	突围
pqly	突袭
pqpq	宜宾
pqps	祖宗
pqpt	宾客
pqqp	宾馆
pqqu	突然
pqre	宜人
pqrr	宜昌
pqsh	突破
pqte	祖先
pqzn	突起
prdl	版面
prds	版本
prgg	牌子
proc	版权
prok	版主
prpr	冥冥
prrd	牌照
pruq	版次
prve	宴会
psca	家长
pscf	神圣
psdf	家在
psdi	家电
psdj	神奇
psdo	神态
psej	审判
psfg	宗教	家教
psfl	家境
psft	家族
psgm	寂静
psgv	家庭
pshb	神秘	家具
pshr	宗旨
psih	家政
psik	家常
pskl	审理
psle	家园
pslf	家里
pslo	神龙
psme	家门
psng	神情
psoh	审核
psoo	审议
psoq	神话
psor	审查
psos	审计
pspm	寂寞	审视
psqb	神色
psre	家人
pssg	家居
pssy	家属
pstl	家务
pstv	神州
psud	审美
psuo	家有
psvx	审批
pswh	家伙
pswj	神仙
psxc	神经
psxv	家乡
psyo	家用
pszo	家中	神舟
ptce	客车
ptcj	客厅
ptcm	客观
ptec	客运
ptfn	客场
ptga	额度
pthf	客房
pthu	客户
ptif	宪法
ptlm	客商
ptmb	客服
ptog	客栈
ptoj	客机
ptps	客家
ptqi	客气
ptre	客人
ptud	额头
ptxp	额外
ptzz	客串
pudf	实在
pufl	实地
puft	实施
pugg	实践
puhk	实战
puhx	实惠
pukm	实现
puli	实力
pulx	实效
pume	实验
pumx	寒风
punq	实物
puoq	实话
pupc	寝室
purf	实时
purs	实质
pusi	实事
pute	实行
putl	实务
putu	寒冬
puuk	实况
puuw	寒冷
puvs	实录
puwd	实体	实例
puwn	寒假
puxi	实习
puxk	实名
puxs	实际
puye	实业
puyo	实用
pvck	窗台
pvdt	容忍
pveb	容貌
pvhk	容积
pvhu	窗户
pvka	避开
pvko	窗口
pvkq	容器
pvlc	容颜
pvmi	避免
pvnv	避孕
pvov	容许
pvpj	窗帘
pvri	容量
pvrq	容易
pvxn	容纳
pvxp	窗外
pwek	宿命
pwip	察觉
pwrm	察看
pwvg	宿舍
pxnk	宛如
pxpz	窈窕
pyfo	穿过
pygg	裙子
pyhk	祥和
pyhn	穿透
pynk	譬如
pyoc	穿梭
pysa	穿上
pyte	穿行
pyum	穿着
pyye	穿衣
pyyk	寓言
pyzh	穿越
qafo	错过
qaip	错觉
qale	错了
qamv	昏迷
qaok	错误
qarl	昏暗
qavf	错失
qbaw	负荷
qbdc	负载
qbdl	迎面	负面
qbdr	迎春
qbek	迎合
qbeo	色彩
qbfo	色狼
qbgb	负责
qbgx	色素
qbhk	迎战
qbic	色泽
qbif	兵法
qbig	锦江
qbim	迎来
qbko	色球
qbkq	兵器
qbkw	色斑
qblf	兵团
qbli	兵力
qbls	迎新
qblw	氛围
qbng	色情
qbom	色调
qbtv	锦州
qbuo	负有
qbvl	迎接
qbvr	负担
qbwg	负债
qbxh	锦绣
qcca	县长
qcdv	悬殊
qcfw	县城
qcgh	勾引
qchn	县委
qchs	悬疑
qcik	悬赏
qcjc	悬崖
qcji	危及
qcoj	危机
qcpf	危害
qcts	链条
qcvf	悬挂
qcvl	链接
qcwn	悬念
qcxe	危险
qcxj	县级
qcyj	县市
qczn	勾起
qdhl	锻炼
qdip	留下
qdlr	留意
qdlx	留恋
qdng	留情
qdrq	贸易
qdry	留影
qdtk	铸造
qduo	留有
qdwn	留念
qdwo	留住
qdxe	留给
qdxi	留心
qdyk	留言
qega	饼干
qehj	锐利
qelr	锐意
qfdo	千方百计
qfds	基本
qffl	基地
qfif	基于
qfld	基因
qfoj	铺设
qfse	基层
qfsi	基石
qfsj	基础
qfsx	基督
qfuc	基准
qfvk	基金
qfvp	基建
qgbf	钱财
qggg	银子
qgij	银河
qgjh	银川
qgmj	银幕
qgok	银杏
qgqb	银色
qgqs	钱包
qgte	银行
qgvj	钱币
qhgg	乖巧
qhsi	钻石
qhsk	钻研
qiaw	印花
qicf	气压
qick	销售
qidh	气死
qidr	千百
qiec	销魂
qiee	千元
qieo	七彩
qifc	印发
qifn	欠缺
qiga	印度
qigu	千古
qihh	千秋
qiii	其一
qiij	印染
qiir	气派	气温
qiiy	气流
qijg	销毁
qiko	气球
qikw	气味
qile	欠了
qilf	千里
qilr	印章
qimm	七月
qins	气愤
qioi	印证
qion	印记
qipg	锁定
qiph	其它
qipu	其实
qiqb	气氛
qirg	其后
qiri	销量
qirs	气质
qirv	七星
qish	印尼
qisi	七十
qisj	印刷
qisx	气息
qita	七年	千年
qiti	七天
qitj	印制
qito	销往
qitp	气管
qiuo	且有
qiuq	其次
qivk	千金
qivl	气势
qivy	其余
qiwa	千万
qiwd	气体
qiwh	气候
qiwl	其他
qixi	印象	气象	七夕
qizo	其中
qjqf	斯基
qjqw	饥饿
qjtm	铅笔
qjwe	斯文
qjxr	岳阳
qkan	乱世
qkek	适合	辞职
qkfc	辞去
qkga	适度
qkge	乱弹
qkgg	句子
qkgi	适应
qkhh	锅炉
qkiv	适当
qkkg	句号
qkle	够了
qkoq	句话
qkpb	甜蜜
qkpq	适宜
qkre	敌人
qkrf	适时
qkri	适量
qksm	乱码
qkud	舌头	甜美
qkyo	够用
qkzo	适中
qlcc	重叠
qlda	重大
qlgd	重庆
qlgg	镜子	饺子
qlgt	助攻
qlhk	重点	重启
qlim	重来
qlip	重演	助学
qlir	重温
qlkj	重型
qlkl	助理
qlkm	重现
qlli	助力
qllk	重回
qlls	重新
qlpm	重视
qlql	重重
qlrc	重返
qlre	助人
qlri	重量
qlse	重申
qlso	助手
qltf	重逢
qltr	重复
qlud	镜头
qlus	重装
qlvb	重创
qlvg	重生
qlvk	重金
qlvp	重建
qlwq	助你
qlwt	重伤
qlwv	重任
qlwx	镜像
qlxc	助阵
qlxi	重心
qlxn	重要
qlxq	重组
qmgj	期刊
qmia	期满
qmio	期末
qmkk	钢琴
qmmb	期盼
qmmr	期间
qmne	期内
qmof	钢材
qmor	钢板
qmqv	钢铁
qmsh	钥匙
qmtf	期待
qmtm	钢筋
qmtp	钢管
qmwm	期望
qmwq	期货
qmxf	铜陵
qmxg	期限
qmxx	钢丝
qncf	甚至
qnec	乌云
qnlo	乌龙
qnmu	饲料
qnpw	勘察
qnql	乌龟
qnuy	饲养
qnvp	勘探
qnyn	乌鸦
qowq	孵化
qqep	饱受
qqhk	饱和
qqia	饱满
qqiy	饮酒
qqkk	饮品
qqmh	欺骗
qqmu	饮料
qqov	欺诈
qqqb	欺负
qqsu	饮水
qqwg	饮食
qqyo	饮用
qqyu	钓鱼
qrae	饭菜
qrgh	饭店
qrlt	忽略
qrnw	匆忙
qrpm	忽视
qrqr	匆匆
qrqu	忽然
qrrg	饭后
qrsp	饭碗
qrud	馒头
qscf	针对
qsgg	包子
qsgm	镇静
qsig	镇江
qslw	包围
qsmm	包月
qspg	镇定
qspv	包容
qspw	包袱
qsqy	针灸
qsud	包头
qsus	包装
qsvq	包括
qswn	包含
qsxk	针织
qsyl	包裹
qthj	锋利
qtip	饰演
qtnq	饰物
qtqo	乒乓
qudm	然而
qugg	曲子
qumu	曲目
qurg	然后
quvj	曲折
quxg	曲线
qvad	急切
qvcy	铁通
qvdf	争夺
qvec	争取
qvgt	铁路
qvhx	迁移
qvif	急于
qvke	雏形
qvkx	争吵
qvle	急了
qvlj	争端
qvns	秉承
qvnv	急性
qvnw	急忙
qvom	争相
qvoo	争议	急救
qvov	争论
qvqi	争气
qvsg	急剧
qvsv	急速
qvus	铁道	争斗
qvvm	铁血
qvvy	键入
qvvz	争执
qvwk	急促
qvxw	皱纹
qvyd	急需
qvyg	争霸
qvzm	键盘
qwdh	饿死
qwoo	铃木
qwsn	铃声
qxcm	乐观
qxfe	乐坛
qxif	乐于
qxje	乐山
qxkq	乐器
qxle	乐园
qxlf	乐团
qxlr	乐意	乐章
qxon	铭记
qxqu	乐曲
qxxr	乐队
qxxs	钞票
qxze	乐趣
qyai	角落
qyam	解散
qycf	解压
qydi	触电
qyec	触动
qyee	久远
qyfb	触犯
qyfc	触发
qyft	解放
qyga	角度
qygm	解毒
qyjg	镶嵌
qyji	触及
qyka	解开
qylk	解剖
qylx	解梦
qyme	解脱
qyoe	解说
qyoj	解析
qyoo	解救
qyos	解读
qypb	解密
qyqb	角色
qyqi	氧气
qyqy	久久
qyrg	邂逅
qysm	解码
qysv	角逐
qyte	解答
qyun	解决
qyvm	解释	触摸
qywo	千言万语
qywq	氧化
qywv	久违
qyxv	解除
qzep	钟爱
qzge	钟表
qzng	钟情
qzsn	钟声
ragv	暴跌
rahj	暴利
raig	暴涨
rali	暴力
ramx	暴风
rayg	暴露
rayu	暴雨
rcbv	返还
rccf	反对
rcdl	反面
rcdm	反而
rcec	反动
rcge	反弹
rcgi	反应
rcgj	反恐
rcgw	反腐
rcih	反正
rciw	晨光	反光
rcjb	反击
rckv	反响
rcle	反了
rclk	返回
rclx	反思
rcmk	反问
rcmx	反驳
rcon	反之
rcqz	反馈
rcru	晨曦
rcry	反映
rcsf	反射
rctr	反复
rcug	反差
rcvb	晨报
rcvy	反抗
rcwc	反倒
rcwg	反感
rcxv	反省
rdcb	照顾
rdiw	照耀
rdom	照相
rdoy	照样
rdpi	照片
rdrm	照明
rdsf	照射
rdum	照着
rdyp	照亮
rean	人世
rebu	最不
reca	最长
recd	人参
recm	最能
reda	人大	最大
redf	人寿
reek	人命
reep	最爱
refq	人均
refv	人才
regk	最强
rego	人工
rehb	最具
rehk	人和
rehq	人称
reih	人潮
reit	人海
reiy	人流
rejv	最近
rekb	人员
rekk	人品
reko	人口
reli	人力
rels	最新
rema	人马
remd	人类
remn	人数
remr	人间
renb	最怕
reng	最好	人情
renh	人民
renn	最快
renq	人物
renv	人性
reoc	人权
reod	最棒
reoj	人机
reol	人为	最为
reot	人格
repd	最初
reps	人家
reqi	暖气	人气
reql	最重
rere	最最
rerg	最后
rers	人质	最早
rerw	暧昧
rery	人影
rese	人身
resg	最短
resi	人士	人事
reso	人手
rete	人选	最先
retk	人造
reud	人头	最美
reug	最差
reum	最前
reuo	最有
reuq	人次
reus	人道
revg	人生
revk	最全
revo	最热
rewd	人体	最优
rewe	人文
rewf	最佳
rewm	人们
rewq	最低
rewx	人像
rexi	人心	最小
rexk	人名
rexs	人际
rext	最终
rexv	最少
rexx	人缘
reyk	人群
reym	最高
reyt	最酷
rfab	时节
rfax	时区
rfbd	时分
rfca	时长
rfce	时髦
rfcf	时至
rfdj	时段
rfdm	时而
rfhj	时刻
rfih	时政
rfik	时常
rfim	时尚
rfip	时下
rfiw	时光
rflx	时效
rfmr	时间
rfoj	时机
rfop	时评
rfpg	时空
rfqm	时期	暑期
rfqz	时钟
rfrf	时时
rfri	时日
rfsi	时事
rfsv	时速
rfug	时差
rfus	时装
rfvb	时报
rfwh	时候
rfwn	暑假
rfwy	时代
rfxg	时限
rgbi	后卫
rgck	后台
rgdl	后面
rgfa	后方
rgfr	后者
rggv	后退
rgim	后来
rgjl	后勤
rglo	后果
rgme	后门
rgnt	后悔
rgoj	晴朗
rgon	后记
rgqm	后期
rgre	后人
rgrs	后盾
rgti	后天	晴天
rgtl	后备
rgtr	晓得
rgve	后会
rgwy	后代
rgxc	后缀
rgxs	后续
rgyj	后市
rhje	爬山
rhte	爬行
riai	日落
ricl	日历
ridf	量在
rids	日本
riec	晃动
riee	日元
rigg	日子
rihk	日程
rihw	日韩
riic	日渐
riik	日常
riiw	日光
rijj	日出
rilc	日产
rili	日立
rimm	日月
rine	日内
riof	拜访
rion	日记
riow	日语
ripc	日军
riqm	日期
rird	日照
rirg	日后
riri	晃晃	拜拜
rise	量身
risg	日剧
risx	日志
rita	拜年
riub	日益
rium	日前
rivb	日报
rivv	拜托
riwe	日文
riwq	量化
riyo	日用
riyw	日夜
rizq	日趋
rkhg	旺季
rkwn	旺盛
rlan	暗藏
rlee	曼联
rlhr	暗香
rlih	暗淡
rliw	曙光
rllx	暗恋
rlrl	暗暗
rlsi	暗示
rlxs	暗杀
rlyw	暗夜
rlzi	暗自
rlzo	暗中
rmba	明白
rmcf	看到
rmck	看台
rmfo	看过
rmhk	看点
rmhm	明朝
rmhn	看透
rmhx	晚餐
rmif	看法
rmig	明清	看清
rmim	看来
rmjj	看出	冒出
rmko	看球
rmkv	明珠
rmle	明了
rmlt	看图
rmmm	明月
rmmq	看见
rmmr	晚间
rmna	看懂
rmng	看好
rmnn	明媚	明快
rmnx	看那
rmoj	明朗
rmor	看板
rmpf	看守
rmpn	晚安
rmqf	明基
rmql	看重
rmqm	晚期
rmqr	晚饭
rmre	人见人爱
rmri	明日
rmrm	看看	明明
rmrv	明星
rmry	明显
rmsa	晚上	看上
rmsk	明知	明智
rmsq	明确
rmsu	看书
rmta	明年	晚年
rmtf	看待
rmti	明天
rmui	看病
rmum	冒着	看着
rmvb	晚报
rmve	晚会
rmwh	看似
rmwm	看望
rmwn	看成
rmwv	看作	看这
rmwy	明代
rmxe	冒险
rmxl	明细
rmye	冒充
rmyp	明亮
rmzo	看中
rnca	所长
rncf	所致
rncm	所能
rndc	所载
rndf	所在
rnho	所以
rnip	所学
rnmq	所见
rnoe	所说
rnol	所谓
rnsi	所示
rnsk	所知
rnsy	所属
rntr	所得
rnuo	所有
rnvh	所指
rnwg	所做
rnyd	所需
rpwc	晕倒
rqhn	剔透
rqif	易于
rqna	易懂
rqyo	易用
rqzi	昂贵
rrai	坐落
rrap	晶莹
rrbu	从不
rrce	坐车
rrcf	坐到
rrdm	从而
rrhh	从此
rrij	从没
rrim	从来
rrip	坐下
rriw	曝光
rrli	丛林
rros	坐标
rrpi	昌平
rrpv	从容
rrsi	从事
rrsu	丛书
rrud	从头
rrum	从前
rrwd	晶体
rrwe	从未
rrwn	从今	昌盛
rrxi	从小
rrye	从业
rrzo	从中
rsdf	早在
rsfl	质地
rshh	早些
rshk	早点
rshq	昵称
rshs	质疑
rshx	早餐
rsks	卑鄙
rsmk	质问
rsnn	早已
rsoe	质检
rsqm	早期
rsqr	早饭
rsrc	早晨
rsri	质量	早日
rsrm	早晚
rsrs	早早
rssa	早上
rssk	早知
rsta	早年
rsuo	早有
rsvb	早报
rswg	质感
rsyx	早就
rszn	早起
rucs	从头到尾
rvce	星辰
rvgr	星座
rvhu	星火
rvij	星河
rviw	星光
rvjl	殷勤
rvko	星球
rvmm	星月
rvpg	星空
rvqm	星期
rvri	昨日
rvrm	昨晚
rvrv	星星
rvti	昨天
rvxj	星级
rvxs	星际
rvyw	昨夜
rxco	昆虫
rxje	昆山
rxrm	昆明
rxvh	昆仑
ryaf	显著
ryax	景区
rycf	景致
rycm	景观
ryco	影集
rydg	显存
ryfe	影坛
rygg	影子
ryhk	景点
ryjj	显出
rykm	显现
rykv	影响
rylr	影音
rymg	显眼
rymv	影迷
rynq	景物
ryop	影评
rypi	影片
rypm	影视
ryqb	景色
ryqi	景气
ryqu	显然
ryrv	影星
rysa	影碟
rysf	映射
rysi	显示
rysp	显卡
rytr	显得
rywx	影像
ryxi	景象
ryxp	影院
ryyg	显露
saax	展区
sace	上车
sacj	展厅
sack	上台	展台
sadc	上载
sadl	上面
saeo	异彩
safa	上方
safc	上去
safg	异域
safl	异地
safn	上场
sago	上床
sagt	上路
sahh	上乘
saif	上游
saig	上涨
saik	异常	殿堂
saim	上来
saip	上下	上学	上演
sait	上海
saiv	上当
saje	上山
sajj	展出
sajm	上岗
sajt	展览
sajv	上进
saka	展开
sakj	上班
sakm	展现
sakw	异味
sale	砸了
salk	臀部	异国	上部
salp	上帝
same	上门
samf	上周
samm	上月
samx	上网
sang	上司	上好
sanv	异性
saoi	上证
saoj	上诉
saol	上课	上榜
saom	上调	上楼
saoo	上述	异议
saoy	异样
sapg	上空
saqi	展销
sary	上映
sase	上身	上层
sasi	展示
saso	上手
sata	上年
satf	上等	上街
sath	上篇
sati	上天
saum	上前
sauo	上有
sauq	上次
saus	上装
saux	上将	上瘾
sava	上升
savb	上报
save	展会
savg	上午
savh	上个
savn	上扬
sawa	上万
sawd	躯体
sawf	上传
sawl	展位
sawm	展望
sawv	上任
saxc	矩阵	上阵
saxg	上限	上线
saxj	上级
saxv	异乡
saye	上衣
sayj	上市
sbyn	身不由己
scgg	屋子
scjd	屋顶
scjj	支出
sclk	支部	支架
scml	翅膀
scoo	支柱
scoq	屋檐
scte	支行
scve	支援
scvf	支持
scvi	支撑
scwf	支付
scxr	支队
scxs	支票
scyn	支配
sdlo	硕果
sdmu	题目
sdof	题材
sdol	题为
sdsi	硕士
seab	屏蔽
sean	身世
secf	碰到
sedl	层面
segg	身子
seke	身形
selb	申办
selp	身旁
selv	身边
semj	屏幕
seof	身材
seog	申请
seoj	申诉
seol	身为
seom	层楼
sepy	身穿
serg	身后
serm	申明
sery	身影
sesa	身上	身躯
sese	层层
seso	身手
setp	身处
seuq	层次
sevb	申报
sevl	碰撞
sewa	身亡
sewb	身份
sewd	身体
sewk	屏保
sewv	身价
sexi	身心
sexl	屏障
seym	身高
sfbq	导购
sfbv	硅谷
sfcf	导致
sfda	博大
sfeo	博彩
sfep	博爱
sfge	导弹
sfif	导游
sfip	导演
sfjb	射击
sfjj	导出	射出
sfjt	博览
sflo	屠龙
sfme	射门
sfos	导读
sfpt	博客
sfsi	博士
sfso	射手
sftr	博得
sfvb	导报
sfvm	导向
sfvy	导入
sfxs	屠杀
sfyo	博弈
sfzy	导航
sgbs	矿泉
sgcj	短暂
sgdj	剧烈
sgds	剧本
sgfc	短发
sgfn	短缺	剧场
sgga	硬度
sgje	矿山
sglc	矿产
sgng	剧情
sgnh	居民
sgnq	矿物
sgow	短语
sgpc	居室
sgpg	短裤
sgps	居家
sgpy	短裙
sgqm	短期
sgqu	居然
sgrd	剧照
sgsg	短短
sgsi	居士
sgth	短篇
sgvj	硬币
sgwn	硬件
sgwo	居住
sgwq	硬化
sgwy	短信
sgxg	短线
sgxp	剧院
sgxq	剧组
sgxx	居多
sgye	矿业
sgzm	硬盘
shad	真切
shaf	破获
shcf	直到
shcm	直观
shcp	直辖
shcy	直通
shde	真的
shdj	破裂
shdl	直面
shds	直奔
shdv	直达
shep	真爱
shfb	破坏
shgv	尼康
shhc	真皮
shhr	破旧
shhu	破烂
shih	真正	破灭
ship	直觉
shiy	直流
shjb	直击
shkl	真理
shlc	破产
shli	直立
shlo	尼龙
shme	破门
shng	真情	真好
shol	真谛
shom	真相
shoq	真话
show	真诚
shpg	真空
shpu	真实
shqi	直销
shqy	破解
shsi	真是
shsy	破碎	直属
shtc	直径
shvf	丧失	直拨
shvh	直指
shvl	直接
shvs	真挚
shvv	直播
shwc	颠倒
shwn	真假
shwo	真伪
shxg	直线
shxi	真心
shxt	颠覆
shyk	直言
siai	示范
siay	石英
siba	十八
sibd	十分
sibk	是否
sicw	事与愿违
sida	十大
side	是的
sidh	石灰
sier	事儿	十二
sifa	十堰
sife	是非
sigd	事项
sigt	事故
sihl	硝烟
siie	十三
siii	十一
siiy	石油
siji	十九	十几
sikh	十足
sikm	是吗
sikq	石器
sikx	是啊
sile	十四
sili	十六
silr	示意
simm	十月
sing	事情
sinq	事物
siof	史诗	石材
siov	石桥
sipg	十字
sipq	事宜
sipu	事实
siqb	士兵
siqi	士气	十七
sirg	事后
siri	十日
sisa	史上
sita	十年
site	事先
sitl	事务
siud	石头
sium	事前
sivh	十个
siwa	十万
siwd	尸体	事例	示例
siwf	十佳
siwi	示威
siwn	事件
siwq	石化
siwu	十五
sixx	十多
siye	事业
siyo	事迹
siyp	石膏
sjdf	躲在
sjmb	屈服
sjpv	躲避
sjsp	刷卡
sjya	刷牙
skcm	智能
skey	吉普
skfc	研发
skff	智慧
skfr	智者
skhj	智利	吉利
skip	知觉
skkh	知足
skli	智力	吉林
sklm	智商
sklr	知音
skng	知情
sknn	知己
skof	研讨
skok	知识
skpj	研究
skpy	吉祥
skrg	知晓
sktj	研制
skus	知道
skwh	研修
skwl	吉他
skxi	知心
skxk	知名
slgg	鼻子
slhk	协和
slie	鼻涕
sllb	协办
sllm	协商
slmg	协同
slom	协调
sloo	协议
slpg	协定
slql	协助
slve	协会
slwv	协作
smax	南区
smba	尾巴
smcy	南通
smda	南大
smfa	南方
smfe	南非
smge	码表
smgt	南路
smgu	南瓜
smhh	南北
smig	南湖
smip	南下
smit	南海
smiy	南洋
smjc	南岸
smka	南开
smlk	南部	南国
smoj	南极
smpj	南宁
smrr	南昌
smsa	献上
smse	献身
smsm	屡屡
smsn	尾声
smud	码头	南美
smxe	献给
smxr	南阳
smya	南亚
smyc	磷酸
smyx	南京
snca	局长
sncy	畅通
sndl	局面
snfg	局域
snhk	卖点
snhq	声称
snie	卖淫
snif	畅游
snii	声誉
snjj	卖出
snkv	声响
snle	卖了
snlk	局部
snlr	声音
snoh	畅谈
snqb	声色
snqi	畅销
snrm	声明
snsp	声卡
snsx	声息
snus	声道
snvh	卖掉
snvl	局势	声势
snwm	声望
snxe	卖给
snxg	局限
snxk	声名
snzo	声中
soay	手艺
soce	手册
sodc	手套
sodj	手段
soec	手动
soge	手表
sogo	手工
soif	手法
soik	手掌
soip	手下
sokh	手足
solf	手里
somf	手脚
somp	手腕
sooi	手柄
sooj	手机
soon	手记
sooo	手术
soov	手枪
sopi	手写
sopm	手臂
soql	手镯
sosa	手上
sotm	手笔
soud	手头
sovf	手持
sovh	手指
sovl	手势
sovs	手提
sowg	手感
soxi	手心
soxs	手续
soxv	手绘
sozo	手中
spbl	索赔
spce	卡车
spcy	卡通
spec	索取
spep	索爱
spgh	索引
spgk	十字路口
spkg	卡号
spnf	卡特
spnv	索性
sppi	卡片
spsh	索尼
spxn	索要
sqad	确切
sqli	确立
sqor	确认
sqov	确诊
sqpg	确定
sqpu	确实
squo	确有
sqwk	确保
sqwy	确信
srhy	尼日利亚
sshj	犀利
ssmk	慰问
stce	整车
stdc	整套
stek	整合
stic	整治
stis	整洁
stke	整形
stkl	整理
stnh	整改
stoj	整机
stpv	整容
stre	整人
stst	整整
sttd	整顿
stte	履行
stti	整天
stvh	整个
stwd	整体
stwj	整齐
subd	水分
sudi	水电
sudl	水面	书面
sudp	磁带
suds	书本
suek	水瓶
suff	水土
sufg	水域
suft	水族
sugc	水库	书库
sugh	书店
sugj	书刊
sugt	水路
suhe	水稻
suhf	书房
suhj	水利
suho	水墨
suhr	书桌	书香
suic	水源
suif	书法
suil	书画	水池
suip	水下
suis	水泥
suiy	水流
sulc	水产
sulf	水里
sulk	书架
sulo	水果
sumu	书目
sunv	水性	磁性
suon	书记
suop	书评
supi	水平	书写
suqs	书包
sure	水暖
surr	水晶
surs	水质
susa	水上
susc	书屋
suso	水手
susp	水壶
suss	水泵
sute	书签
sutl	书籍
sutp	水管
suuc	水准
suvg	书生
suwl	水位
suwq	水货
suwy	书信
suxf	束缚
suxk	书名
suxp	书院
suxv	水乡
suzm	磁盘
svex	速递
svga	速度
svhh	逐步
svic	逐渐
svih	矫正
svii	逐一
svor	速查
svta	逐年
svvh	逐个
svwn	速成
svyx	速率
sxcb	志愿
sxmj	屁股
sxsf	督导
sxsx	叔叔
sxwk	督促
sxxs	硒鼓
sycf	迟到
syfo	尺寸
syga	尺度
syhs	迟疑
syif	属于
syle	尽了
syli	尽力
syng	尽情
synn	尽快
synv	属性
sypi	碎片
syqt	迟钝
syrf	届时
syri	尽量
syrs	迟早	尽早
syry	尽显
sytp	尽管
syud	尽头
syyc	硫酸
syyg	尽享
syyw	昼夜
taal	年薪
tacc	年轻
tacw	年龄
tafh	年老
tafq	年均
taga	年度
tagm	年青
tagq	彻底	年底
tahj	年利
taio	年末
tajt	年鉴
talc	年产
talf	年里
tamm	年月
tamr	年间
taoe	年检
tapd	年初
targ	年后
tata	年年
taud	年头
taum	年前
tavb	年报
tave	年会
tawb	年份
tawc	年仅
tawq	年华
tawy	年代
taxg	年限
taxj	年级
taxn	年纪
taxt	年终
taxv	年少
tdcj	舞厅
tdck	舞台
tdco	筹集
tdec	舞动
tdge	舞蹈
tdgo	筹划
tdnh	笨蛋
tdqu	舞曲
tdrf	顿时
tdsm	筹码
tdtl	筹备
tdve	舞会
tdvp	筹建
tebq	选购
teca	行长
tece	行车
tedj	行列
teec	行动	选取
tefr	行者
tegd	选项
tegi	答应
tegp	行踪
tehk	行程
tehs	答疑
teih	行政
teii	选举	赞誉
teik	赞赏
tejj	选出
tejv	先进	行进
tekc	赞叹
teld	答辩
telf	签署
tema	先驱
temg	赞同
tems	行驶
teng	行情	选好
teoe	先说
teog	行李
teoi	签证
teoj	签订	先机
teol	行为
tepg	签字	选定
tepn	答案
teqi	行销
teql	赞助
teqt	先锋
tere	行人
terg	先后
terv	行星
tesd	答题
tesf	先导
tesi	行事	先是
tesk	先知
teso	选手
tete	先行
teti	先天
tetr	答复
teud	赞美	选美
teum	先前
teus	答道
tevc	选择
tevd	选拔
tevg	先生
tevn	赞扬
tewh	选修
tewl	行使
tewn	赞成
texk	签名
texq	签约
teye	行业
teyo	选用
tezo	行走	选中
tfap	徒劳
tfcf	等到
tfex	徒弟
tfhh	徒步
tfif	等于
tfkj	徒刑
tfmg	等同
tfoj	待机
tfsa	街上
tftb	彷徨
tftd	街舞
tftf	等等	等待
tfud	街头
tfum	等着
tfus	街道
tfwh	等候
tfxj	等级
tfxs	待续
tfyv	待遇
tgca	很长
tgcc	很难	很轻
tgcm	很能
tgda	很大
tgee	很远
tgep	很受
tggk	很强
tgjc	很紧
tgjv	很近
tglx	很累
tgng	很好
tgnn	很快
tgnr	很慢
tgnw	很忙
tgod	很棒
tgom	很想
tgqy	很久
tgrm	很晚
tgrs	很早
tgud	很美
tgug	很差
tguo	很有
tgwq	很低
tgxi	很小
tgxv	很少
tgxx	很多
tgym	很高
thhh	彼此
thjc	彼岸
thjg	篇幅
thli	竹林
thlr	篇章
thto	各种各样
tibi	天赋
tica	天长
tich	天蝎
tick	天台
tico	征集
tida	天大
tifl	天地
tifv	天才
tigg	天子
tigw	天府
tihh	征收
tiho	天黑
tihy	征稿
tiic	天涯
tiij	天河
tiik	天堂
tiip	天下
tiiv	天津
tije	天山
tikk	天王
tikn	天哪
tikx	天啊
tilk	天国
tilo	惩罚	天龙
tilr	天意
tilv	天边
tima	天马
timb	征服
timn	天数
timv	天骄
tinq	征婚
tinv	天性
tioj	天极
tioo	征求
tiov	天桥
tipg	天空
tipi	天宇	天平
tiqb	天色
tiqi	天气
tiqu	天然
tirf	天时
tirg	天晴
tisa	天上
tish	天真
tisu	天水
titi	天天
tits	天籁
tivg	天生	衍生
tiwe	征文	天文
tiwl	天使
tiwn	天鹅
tiwv	天价
tixg	天线
tixp	天外
tixs	天际
tiyp	天亮
tjax	制药
tjcm	微观
tjcq	微软
tjdy	制裁
tjec	制动
tjga	制度
tjgo	策划
tjgu	微弱
tjhz	制止
tjih	微波
tjkj	微型
tjkk	制品
tjko	篮球
tjlt	策略	制图
tjmb	制服
tjmv	制胜
tjmx	微风
tjnx	微妙
tjoj	制订	微机
tjor	篮板
tjpg	制定
tjri	微量
tjrv	微星
tjte	筛选
tjtj	微微
tjtk	制造
tjtv	微笑
tjuw	制冷
tjwj	制剂
tjwn	制成
tjwv	制作
tjwy	微信
tjxi	微小
tjxq	制约
tjyg	制式
tkba	告白
tkbu	各不
tkda	各大
tkfa	各方
tkfl	各地
tkgd	各项
tkgt	各路
tkhz	各种
tkjv	靠近
tkkj	造型
tkkl	告别
tkkt	吞噬
tklk	各国
tklv	各界
tkmd	各类
tkog	告诫
tkoj	告诉
tkon	告之
tkoy	各样
tkpg	造福
tkps	各家
tkqb	各色
tkre	各人
tksa	各异
tksi	告示
tksk	告知
tktp	各处
tkuo	各有
tkvh	各个
tkwl	各位
tkwn	造成	造假
tkwq	造化
tkwv	造价
tkxj	各级
tkxq	造纸
tkxt	告终
tkxv	各省
tkyx	造就
tkzi	各自
tlbi	务必
tlep	备受
tlfg	备考
tlhk	备战
tlio	备注
tllb	籍贯
tllh	笼罩
tlpn	备案
tlpu	务实
tluo	备有
tlwb	备份
tlwx	备忘
tlyo	备用
tmap	繁荣
tmcf	每到
tmcl	简历
tmdb	每页
tmds	繁殖
tmek	算命
tmel	简单
tmfr	笔者
tmhq	简称
tmhz	每种
tmif	算法
tmil	笔画
tmip	笔下
tmis	简洁
tmiv	每当
tmki	繁琐
tmlr	简章
tmmf	每周
tmmj	每股
tmmm	每月
tmnh	篡改
tmnw	繁忙
tmon	简讯	笔记
tmoo	简述
tmoy	笔试
tmqe	敏锐
tmre	每人
tmri	每日
tmrm	简明	每晚
tmrq	简易
tmsg	简短
tmsh	简直
tmsi	算是
tmta	每年
tmtf	每逢
tmti	每天
tmtm	每每
tmts	每条
tmtv	衢州
tmuq	每次
tmvb	简报
tmvh	每个
tmvj	简介
tmvv	敏捷
tmwd	繁体	简体
tmwg	敏感	简便
tmwl	每位
tmwn	每件
tmwq	简化	繁华
tmxg	每隔
tmxi	简陋
tmxk	笔名
tmxn	简要
tmxq	简约
tmxx	繁多
tngg	筷子
toar	往昔
togg	箱子
toik	往常
toim	往来
toip	往下
toqs	箱包
torc	往返
torg	往后
tori	往日
tosa	往上
tosi	往事
tota	往年
toto	往往
toum	往前
toxp	往外
tpan	处世
tpbd	处分
tpca	处长
tpcp	管辖
tpdf	处在
tpfa	处方
tpfl	处境
tpif	处于
tpkl	管理	处理
tplo	处罚
tpls	处置
tpnv	处女
tpof	管材
tpps	管家
tpsi	处事
tptj	管制
tptp	处处
tpus	管道
tpwl	管他
tpwn	管件
tpxg	管线
tpyo	管用
tqri	衡量
tqsu	衡水
tqvl	衔接
tqxr	衡阳
tral	复苏
trbd	得分
trcb	复原
trcf	得到
trek	复合
trfc	复发
trgu	复古
trhj	得利
trho	得以
trii	复兴
trim	得来
triq	复活
triv	得当
trjj	得出	复出
trjs	复杂
trkb	循环
trle	得了
trlf	得罪
trli	得力
trlr	得意
trok	得主
tros	复读
trqi	复印
trri	复旦
trsk	得知
trso	得手
trtg	得很
trtj	复制
trux	得奖
trvf	得失
trwd	得体
trwj	复仇
trxi	复习
trxk	得名
trxs	得票
tsfs	条款
tsji	德甲
tslk	德国
tsmu	条目
tsow	德语
tssm	条码
tstv	德州
tswd	条例
tswe	条文
tswn	条件
tsxq	条约
tsxw	条纹
tsym	德育
tuhg	冬季
turi	冬日
tuti	冬天
tvia	徐汇
tvji	律师
tvle	笑了
tvlr	笑意
tvme	笑脸
tvoq	笑话
tvpv	笑容
tvsn	笑声
tvtv	徐州
twek	符合
twkg	符号
txba	第八
txer	第二
txie	第三
txii	第一
txji	第九
txle	第四
txli	第六
txqi	第七
txsi	第十
txwu	第五
tyih	乞丐
tywn	迄今
uaxs	冻结
ubgg	痞子
ubsk	益智
ubtp	益处
ubug	疤痕
ubvy	卷入
ubxr	益阳
ucag	痛苦
ucbj	准则
uchl	冶炼
uckq	痛哭
ucln	痛楚
ucls	痉挛
ucmx	痛风
ucng	痛恨
ucnn	痛快
ucrf	准时
ucsq	准确
uctl	准备
ucuq	瘫痪
ucvk	冶金
ucvy	准入
ucxi	痛心
udcm	美观
udde	美的
uddh	头盔
udeb	美貌
udee	美元
udek	凑合
udfc	头发	美发
udfq	美艳
udgo	美工
udhc	头皮
udia	美满
udii	美誉
udim	美丽
udip	美学
udit	美洲
udiy	美酒
udjd	头顶
udkg	头号
udkw	美味
udlk	美国	头部
udlm	券商
udlt	美图
udlx	美梦
udmg	美腿
udmw	头脑
udng	美好
udnm	美眉
udnv	美女
udnx	美妙
udoo	美术
udpc	美军
udpv	美容
udqb	美色
udre	美人
udri	美日
udrp	头晕
udry	美景
udsa	头上
udtq	头衔
udts	美德	头条
uduc	头痛
udut	头疼
udvk	美金
udwg	美食	美感
udwq	美化
udwx	头像
ueaw	兰花
uetv	兰州
ufqk	凌乱
ufrc	凌晨
ugcg	差劲
ugga	差距
ughk	差点
ugkl	差别
ugqa	差错
ugsa	差异
ugwv	差价
ugyo	痕迹
uhap	疲劳
uhcq	疲软
uhec	凝聚
uhir	有朝一日
uhlg	凝固
uhpm	凝视
uhtl	疲惫
uhwm	凝望
uhwu	疲倦
uhxs	凝结
uigo	病床
uihf	病房
uikl	病理
uilc	病变
uild	病因
uing	病情
uire	病人
uiui	病症
uiuq	症状
uiwd	病例
ujal	疫苗
ujng	疫情
ujse	瘦身
ukqi	况且
ukui	癌症
ulif	疗法
ullx	疗效
ulwt	疗伤
umad	剪切
uman	前世
umat	煎熬
umau	盖茨
umbi	前卫
umck	前台	剪辑
umda	剪刀
umdj	前列	前段
umdl	前面
umdt	前奏
umfa	前方
umfc	前辈	前去
umfr	前者
umgg	疯子
umhh	前些
umhk	前程
umij	前沿
umim	前来
umjv	前进
umks	着呢
umle	疯了
umli	着力
umlj	前端
umlx	眷恋
ummg	着眼
umml	塑胶
ummq	前瞻
ummu	塑料
ummv	着迷
umom	着想
umpu	着实
umql	着重
umqm	前期
umqt	前锋
umqv	着急
umre	前人
umrg	前后
umri	前日
umry	前景	剪影
umse	前身
umso	着手
umsy	眷属
umta	前年
umte	前行
umti	前天
umtk	塑造
umto	前往
umuo	前有
umus	着装
umvs	前提
umvy	前途
umxg	前线
umxi	前夕
umyk	前言
umyw	凋零
unbu	决不
unhk	决战
unid	羞涩
unmv	决胜
unoo	决议
unpb	决赛
unpg	决定
untj	决策
unxi	决心
uoce	有车
uode	有的
uoet	有关
uofe	有幸
uofo	有过
uogm	有毒
uogy	有序
uohh	有些
uohj	有利
uohk	有点
uohs	有疑
uohz	有种
uoid	有无
uokl	有理	有别
uokv	有啥
uole	有了
uoli	有力
uolk	有加
uolr	有意
uolx	有效
uomk	有问
uomn	有数
uong	有情
uonk	有如
uooc	有权
uooj	有机
uook	有误
uool	有为
uopf	有害
uopg	有空
uoqa	有错
uoqb	有色
uoqg	有钱
uoql	有助
uoqm	有期
uorf	有时
uorn	有所
uosi	有事
uosx	有志
uotf	有待
uoub	有益
uoui	有病
uovh	有个
uovk	有损
uovy	有余
uowg	有感
uowi	有偿
uowj	有何
uowm	有望
uown	有成
uoxg	有限	有线
uoxi	有心
uoxk	有名
uoxx	有缘
uoyo	有用
uoze	有趣
uqbg	盗贼
uqcl	资历
uqdo	状态	姿态
uqds	资本
uqee	状元
uqfb	资费
uqff	净土
uqgy	次序
uqic	资源
uqip	资深
uqkq	瓷器
uqlc	资产
uqmn	次数
uqmu	资料
uqon	资讯
uqoq	咨询
uqot	资格
uqpa	盗窃
uqpr	盗版
uqqc	盗链
uqql	资助
uqri	次日
uqrs	资质
uqsf	瓷砖
uqsu	净水
uqtk	状告
uquk	状况
uqvk	资金
uqvl	姿势
uqwq	净化
uqxn	次要
urcf	曾对
urdf	曾在
uroe	曾说
uroo	脊柱
ursi	曾是
uruo	曾有
urwv	曾任
urxc	曾经
uscm	壮观
uscv	首轮
usda	壮大
usdb	首页
usdc	装载
usdf	装在
usfc	首发
usff	冰封
usfn	首场
usfr	首都
usft	壮族
usga	首席	首度
usgc	首张
usgt	道路
ushb	道具
ushj	冰灯
usia	装潢	装满
usim	壮丽
usjb	拳击
usje	冰山
usjh	装帧
usji	装甲
usjq	道歉
uskl	道理
usko	痴呆
uslk	首部
usls	装置
usmv	痴迷
usmw	首脑
usng	痴情
usoj	装订	装机
usom	首相
uspg	首富
usps	首家
usqm	首期
usqt	装饰	首饰
usqv	斗争
usri	首日
usry	首映
ussa	装上
ussi	道士	斗士
ussx	斗志	壮志
ussy	首届
uste	首先	首选
ustl	装备
usto	冰箱
usts	道德
usua	冰冻
usud	拳头
usui	疾病
usuo	装有
usuq	首次
usuw	冰冷
usuy	冰凉
usvb	装扮	首创
usvh	首个
usvx	首批
usvy	装入
uswc	首领
uswd	首例
uswh	装修
uswl	首位
uswv	装作
usxi	痴心
usxn	首要
usyn	装配
usyv	冰雪
utep	疼爱
utua	疙瘩
utuc	疼痛
uumx	羡慕
uvcf	逆转
uvem	痊愈
uvud	凄美
uvuy	凄凉
uwai	冷落
uwan	冷藏
uwcc	减轻
uwcf	减压
uwfc	冷却
uwgm	冷静
uwgu	减弱
uwgv	减退
uwhk	冷战
uwig	冷汗	冷清
uwih	冷淡
uwim	冷漠
uwmb	减肥
uwme	冷门
uwmg	冷眼
uwmi	减免
uwqi	冷气
uwre	冷暖
uwsu	冷水
uwsv	减速
uwtv	冷笑
uwua	冷冻
uwvo	冷热
uwxe	减缓
uwxi	减小
uwxv	减少
uwyt	冷酷
uxbn	有限公司
uxcf	将至
uxcw	奖励
uxdv	将达
uxfx	慈悲
uxgd	奖项
uxie	慈溪
uxif	将于
uxim	将来
uxiy	酱油
uxjv	将近
uxkk	奖品
uxmx	郁闷
uxpc	将军
uxph	将被
uxpr	奖牌
uxqi	将其
uxsi	将士	将是
uxuo	将有
uxve	将会
uxvk	奖金
uxwl	将使
uxxn	将要
uxyu	慈善
uxyx	将就
uyds	养殖
uydx	凉爽
uyfh	养老
uyiq	养活
uymx	凉风
uyvg	养生
uyvh	养护
uywn	养成
uyym	养育
uzcf	冲压
uzec	冲动
uzio	冲浪
uzit	冲洗
uzjb	冲击
uzjj	冲刺	冲出
uzjv	冲进
uzpq	冲突
uzqi	冲印
uzqt	冲锋
uzsh	冲破
uzti	冲天
uzvm	冲向
vacf	升至
vaft	措施
vahh	搭乘
vaip	升学
vair	升温
vanv	撒娇
vaoa	撒谎
vaoi	搭档
vaoo	描述
vapi	描写
vasa	搭上
vavp	搭建
vawq	升华
vaws	升值
vaxj	升级
vaxq	拒绝
vaxt	升降
vaxv	描绘
vaym	升高
vayn	搭配
vazn	升起
vbaq	报警
vbcf	报到
vbet	报关	把关	报送
vbfg	报考
vbgc	仓库
vbge	报表
vbgf	报废
vbgj	报刊	创刊
vbip	扮演	创下
vbjj	拍出	创出
vblb	创办
vbli	创立
vblr	创意
vbls	创新
vbmu	报料
vbnc	创始
vbpf	报社
vbqi	报销
vbrd	拍照
vbsf	报导
vbsn	拍卖
vbso	把手
vbte	报答
vbtk	报告	创造
vbtr	报复
vbus	报道
vbve	拍摄
vbvp	创建
vbvs	把握
vbwj	报仇
vbwk	仓促
vbwo	仓储
vbwt	创伤
vbwv	创作	报价
vbxk	报名
vbxq	报纸
vbye	创业	报业
vbyt	报酬
vcad	推荐
vcai	振荡
vcdl	振奋
vcdp	携带
vcec	推动	振动
vcgu	推广
vchx	推移
vcib	推测
vcii	振兴
vcjj	推出
vcjp	推崇
vcjv	推进
vcka	推开
vckl	推理
vcmn	推断
vcqi	推销
vcso	携手
vcsy	推迟
vcte	推行
vcud	抬头
vcvj	推介
vcvm	推向	推翻
vcwl	摊位
vcwv	振作
vczn	抬起
vdey	招聘
vdfg	招考
vdfn	捧场
vdhh	招收
vdhq	招租
vdic	乔治
vdim	招来
vdkh	招呼
vdlm	招商
vdml	招募
vdmn	招数
vdmy	乔丹
vdos	招标
vdpr	招牌
vdqk	扰乱
vdqt	掩饰
vdre	撩人
vdso	招手
vdtf	招待
vdum	掩盖
vdvg	招生
vdvj	夭折
vdyg	招式
vebk	会否
veca	会长
vecf	捡到
vedl	会面
veek	拼命
vefn	会场
veil	摇滚
vekb	会员
velr	拼音
velt	拼图
vemg	会同
vemq	会见
veoc	授权
veoh	会谈
veol	授课
veoo	会议
veoq	会话
veos	会计
veql	援助
veqp	会馆
veri	摇晃
vern	会所
very	摄影
vesa	会上	会展
vetj	摇篮
veud	摇头
veuo	会有
veve	摇摇
vevf	拼搏
vevl	摇摆
vewx	摄像
veyu	授予
vfaf	捕获
vfai	失落
vfbd	扶贫
vfbe	拷贝
vfbt	失败
vfcl	挂历
vfcy	拨通
vfdf	挂在	排在
vfdj	排列
vfem	寻觅
vffc	失去
vfft	排放
vfgp	失踪
vfgy	排序
vfhj	失利
vfik	寻常	失常
vfip	丢下
vfjj	排出
vfjo	排斥
vfkg	挂号	拨号
vfko	排球
vflr	失意
vflx	失效	失恋	寻梦
vfme	丢脸
vfmj	持股
vfmn	失眠	挂断
vfoj	挂机
vfok	失误
vfom	失调
vfoo	寻求
vfpi	持平
vfpk	寻宝
vfpr	挂牌	排版
vfqq	挂钩
vfqy	持久
vfsh	失真
vfsu	排水
vfte	排行
vftq	失衡
vfuo	持有
vfvf	扶持	丢失
vfvg	寻找
vfvh	丢掉
vfvj	拨打
vfvk	捕捉
vfvp	失控
vfwm	失望
vfwn	挂念	挂件
vfxk	排名
vfxr	排队
vfxs	持续
vfxv	排除
vfya	丢弃
vfye	失业
vgam	扩散
vgca	生长
vgcf	找到
vgda	扩大
vgdc	卸载
vgdg	生存
vgdh	生死
vgdo	生态
vgds	生殖
vgec	生动
vgek	生命
vggc	扩张
vggg	生子
vghx	午餐
vgic	生涯	生源
vgif	生于
vgim	生肖	找来
vgip	生下	卸下
vgiq	生活
vgjj	找出	生出
vgkl	生理
vglc	生产
vglk	找回
vglr	生意
vglx	生效
vgmb	舒服
vgnb	生怕
vgnq	生物
vgoj	生机
vgos	生计
vgpi	生平
vgpv	扩容
vgqi	生气
vgqk	舒适
vgqr	午饭
vgre	找人
vgrg	午后
vgri	生日
vgsa	扩展	舒展
vgsn	舒畅
vgtr	舍得
vgui	生病
vgum	生前
vgvf	找寻
vgvp	扩建
vgwn	生成
vgwq	生化
vgxe	舒缓
vgya	舍弃
vgye	扩充
vgym	生育
vgyw	午夜
vhai	掉落
vhbi	护卫
vhca	延长
vhcy	灵通
vhec	灵魂
vhfg	指教
vhgb	指责
vhgg	个子
vhgh	指引
vhgo	企划
vhhb	揭秘
vhhk	指点
vhih	指正
vhip	掉下
vhiq	灵活
vhji	指甲
vhjj	指出
vhjv	掉进
vhka	揭开
vhkb	指环
vhkl	个别	护理
vhkr	个唱
vhlt	企图
vhmf	护肤
vhmj	揭幕	个股
vhmn	指数	个数
vhnv	个性	灵性
vhok	延误
vhos	指标
vhpg	指定	拟定
vhpn	延安	个案
vhqi	灵气
vhqm	延期
vhqs	指针
vhrd	护照
vhre	个人
vhrg	揭晓
vhrm	指明
vhsa	灵异
vhsf	指导
vhsi	指示	护士	揭示
vhsm	指南
vhss	灵犀
vhsy	延迟
vhtm	灵敏
vhud	个头
vhvm	指向
vhvp	指挥	指控
vhwc	指令
vhwd	个体
vhwg	灵感
vhwm	指望
vhwn	企鹅
vhws	延伸
vhxd	指尖
vhxe	延缓
vhxr	揭阳
vhxs	延续
vhxw	指纹
vhye	企业
vhyg	揭露	披露
vifc	抹去
vijh	抚顺
viss	抚慰
viuy	抚养
vive	搅拌
vivm	抚摸
viwo	挡住
vixf	翻来覆去
vizn	撑起
vjan	逝世
vjbd	打分
vjbt	打败
vjcc	折叠
vjcf	打压	打到
vjco	搜集
vjcy	打通
vjde	打的
vjdg	摧残
vjdh	打死
vjec	打动
vjex	投递
vjfc	打发	逝去
vjfg	搜狐
vjfo	打过
vjft	投放
vjgl	折磨
vjgo	打工
vjhy	投稿
vjif	打法
vjii	打消
vjim	打来
vjio	投注
vjip	哲学	打下
vjiw	抛光
vjjb	打击
vjjg	摧毁
vjjj	打出	抛出
vjjv	打进
vjka	打开	抛开
vjkj	打听
vjkl	哲理	打理
vjko	打球
vjkv	打响
vjlc	投产
vjlk	打架
vjlr	介意
vjlx	搜罗
vjmn	打断
vjmu	折腾
vjng	打好
vjoj	投诉	投机
vjor	搜查
vjos	投标
vjpe	打完
vjpg	打字
vjqi	打印
vjqk	打乱
vjqs	打包
vjqv	拆迁
vjri	打量
vjrs	介质
vjry	投影
vjse	投身
vjsf	折射
vjsh	打破
vjsp	搜索
vjtk	打造
vjtm	打算
vjuq	投资
vjus	打斗
vjvb	打扮
vjvd	打扰
vjve	打拼
vjvf	搜寻
vjvj	打折
vjvk	折扣
vjvm	投向
vjvv	打扫
vjvy	投入	介入	打入
vjwc	打倒
vjwk	投保
vjwn	打假
vjwz	打仗
vjxd	介绍
vjxs	投票
vjxt	投降
vjxv	拆除
vjya	抛弃
vjyk	誓言
vjzn	掀起
vkax	全区
vkay	金黄
vkbu	捐赠
vkca	全长
vkcm	全能
vkco	全集
vkdc	全套
vkdl	全面
vkek	全职
vkfb	损坏
vkfn	全场	操场
vkfr	全都
vkfs	捐款
vkgg	金子
vkgm	金融
vkgv	金庸
vkhh	金秋
vkhk	全程
vkhq	全称
vkid	全无
vkiw	金光
vkje	金山
vkka	捉弄
vkkj	全班
vkko	全球
vkli	全力
vklk	全国	全部
vklo	金龙
vkls	全新
vkme	金门
vkmx	金刚
vknh	全民
vkol	全校
vkov	金桥
vkpf	损害
vkpr	金牌
vkps	全家
vkpt	金额	全额
vkqb	金色
vkqc	全县
vkqg	金钱	金银
vkql	捐助
vkqu	全然	金曲
vkrv	金星
vkry	全景
vkse	全身	全屏
vksi	金石
vksn	全局
vksu	全书
vksy	金属
vkta	全年
vkti	全天
vkud	全美
vkux	金奖
vkve	全会
vkvf	损失
vkvj	金币
vkvm	捉摸
vkvp	操控
vkwd	全体
vkwe	全文
vkwt	损伤
vkwv	操作
vkxf	金陵
vkxg	全线
vkxi	操心	全心
vkxr	操纵	全队
vkxv	扣除	全省
vkyj	全市
vkyu	金鱼
vkzm	全盘	操盘
vlax	拉萨
vlbi	势必
vlcf	接到
vlcj	接轨
vlcv	接连
vlcy	接通
vldf	摆在
vlec	拉动
vlep	接受
vlet	接送
vlfo	接过
vlft	摆放
vlhh	接收
vljb	撞击
vljj	拉丁	摆出
vljv	接近	拉近
vlka	拉开
vlkj	接班	接听
vlko	接口
vlkq	接吻
vlli	势力	接力	拉力
vlme	摆脱
vloj	摆设
vlow	粤语
vlpi	摆平
vlqc	拉链
vlqy	接触
vlso	拉手	接手
vltf	接待
vlud	势头
vlum	接着
vlvs	摘录
vlvy	接入
vlwo	拉住
vlxd	捆绑
vlxg	接线
vlxh	摘编
vlxn	摘要	接纳
vlzi	摘自
vmal	番茄
vmcf	血压
vmdg	向左
vmdk	向右
vmec	奥运
vmft	释放
vmhb	奥秘
vmig	搁浅
vmil	翻滚
vmim	向来
vmip	向下
vmiy	血液
vmka	翻开
vmkj	血型
vmkr	翻唱
vmlk	挽回
vmls	翻新
vmme	翻阅
vmmh	血脂
vmmr	血腥
vmnr	血肉
vmnx	奥妙
vmoo	挽救
vmpn	血案
vmpr	翻版
vmqb	血色
vmqd	挽留
vmsa	向上
vmse	翻身
vmsf	向导
vmsh	悉尼
vmsp	摸索
vmto	向往
vmtp	血管
vmum	向前	向着	翻盖
vmvh	拇指
vmxp	向外
vmxr	向阳
vmxy	血统
vmyu	番禺
vmyv	奥迪
vncf	扭转	追到
vngg	妻子	扬子
vngp	追踪
vniu	追溯
vnjb	追击
vnle	扔了
vnlk	追加
vnmk	追问
vnny	追忆
vnoo	追求	拯救
vnpj	追究
vnpu	扎实
vnqu	扭曲
vnrv	追星
vnsa	追上
vnsv	追逐
vntv	扬州
vnvc	抉择
vnvd	追捧
vnvf	追捕	追寻
vnvh	扔掉
vnwi	挪威
vnxr	阜阳
vnxs	追杀
vnxu	追随
vnyo	挪用
vnzg	追赶
vnzn	扬起
vodj	热烈
vodp	热带
voep	热爱
voga	热度
vohk	热点
voih	热潮
voim	热泪
vokw	乏味
vold	热辣
voli	热力
volx	热恋
vome	热门
vomy	热闹
vong	热情
vonp	热忱
voow	热诚
voqi	热气	热销
vori	热量
vose	热身
vosn	热卖
vosu	热水
votd	热舞
vovm	热血
voxg	热线
voxi	热心
voyz	热衷
vpcy	扑通
vpge	扑克
vpgl	按摩
vphb	探秘
vpib	探测
vpif	建于
vpip	按下
vpix	挥洒
vpjb	抨击
vplh	建站
vpli	建立
vplk	建国
vpls	探亲
vpmj	控股
vpof	探讨	建材	探访
vpoj	建设
vpoo	建议
vpoq	建构
vppc	建军
vppj	探究
vpqn	按钮
vpqv	按键
vprd	按照
vprf	按时
vpso	挥手
vpsp	探索
vptd	挥舞
vptg	建筑
vptj	控制
vptk	建造
vpvh	按揭
vpvs	挖掘
vpvy	擦拭
vpwm	探望
vpwn	建成	控件
vpwo	按住
vpxe	探险
vpyc	挥霍
vqdj	撕裂
vqdv	抵达
vqec	换取
vqgk	抑或
vqgr	插座
vqil	插画
vqim	换来
vqjj	掏出
vqjq	抱歉
vqlt	插图
vqme	挣脱
vqoc	插槽
vqqd	拘留
vqqg	挣钱
vqqu	插曲
vqqy	抵触
vqsa	插上
vqsi	抑是
vqtj	抑制	抵制
vqtm	换算
vqtv	抵御
vqud	插头
vqum	抱着
vqux	抑郁
vqvh	换个
vqvi	抵挡
vqvj	抵押
vqvn	挣扎
vqvy	抵抗	插入
vqwn	换成	插件
vqwo	抱住
vqwy	换代
vqxb	抱怨
vraf	抓获
vrbi	捍卫
vrcf	抓到
vrgg	担子
vriv	担当
vrjc	抓紧
vrms	众所周知
vrnd	担忧
vrng	抓好
vrqb	担负
vrre	众人
vrvb	抓拍
vrvg	众生
vrvj	挫折
vrwk	担保
vrwo	抓住
vrwv	担任
vrxi	担心
vrxx	众多
vrzn	抓起
vsay	技艺
vscf	提到
vscm	技能
vsdf	剥夺
vsec	提取	录取
vsgg	技巧
vsgo	技工
vshh	据此
vshl	提炼
vshq	据称
vsif	技法
vsji	技师	提及
vsjj	提出
vskk	提琴
vslr	录音
vslx	提交
vsmk	提问
vsoe	据说
vsoo	技术	提议
vspa	拓宽
vspi	撰写
vspn	提案
vsrs	提早
vssa	拓展
vssi	提示
vsso	握手
vssv	提速
vssy	隶属
vstj	录制
vsum	提前	提着
vsva	提升
vsvd	提拔
vsvf	逮捕
vsvm	据悉
vsvy	录入
vswa	提供
vswe	撰文
vswn	提成
vswo	握住
vswr	提倡
vswx	录像
vsxf	提防
vsxk	提名
vsxn	提要
vsym	提高
vsyo	录用
vsyr	提醒
vszn	提起
vtgf	拖鞋
vtqi	拖欠
vtvh	拖延
vudc	拦截
vuwo	拦住
vvbq	抢购
vvdv	捷达
vvfc	抢劫
vvft	播放
vvge	捷克
vvhk	抢占
vvhz	播种
vvio	抢注
vvjj	播出
vvjv	挺进
vvlk	巡回
vvlx	巡逻
vvmg	抢眼
vvoo	抢救
vvpg	托福
vvpm	巡视
vvtc	捷径
vvte	抢先
vvtp	托管
vvva	扫描
vvvb	播报
vvxv	扫除
vvzm	托盘
vvzo	抢走
vwcf	挤压
vwel	禽兽
vxcm	怎能
vxdj	系列
vxej	批判
vxfc	批发
vxly	抄袭
vxmn	系数
vxop	批评
vxoy	怎样
vxri	批量
vxtr	批复
vxuc	批准
vxvc	怎么
vxvl	全心全意
vxxy	系统
vyal	抗菌
vyan	入世
vyca	擅长
vycf	搞到
vyck	擂台
vyec	抽取
vyfc	抒发
vyfl	余地	入境
vyfn	入场
vyfo	掠过
vygc	入库
vyhk	抗战
vyhl	抽烟
vyik	入党
vyip	入学
vyjb	抗击
vyjj	抽出
vyko	入口
vylw	入围
vymc	入睡
vyme	入门
vymo	入驻
vymx	入网
vyng	搞好	抒情
vynz	余姚
vyok	入主
vyoo	抗议	叙述
vyor	抽查
vyoy	抽样
vypg	抽空	搞定
vypt	余额
vyqa	搞错
vyqi	撤销
vyqv	抗争
vyri	抗日
vysa	抽屉
vyso	入手
vytc	途径
vyte	入选
vytq	抗衡
vytr	搞得
vytv	搞笑
vyuo	拥有
vyux	抽奖
vyva	抗拒
vyvh	拥护
vyvq	拥抱
vyvw	拥挤
vywb	撤离
vywc	摔倒
vywo	入住
vywv	入侵
vyxi	抽象
vyzi	擅自
vyzo	途中
vzaf	执著
vzec	搬运
vzfg	执教
vzgu	挑逗
vzhk	挑战
vzif	执法
vzih	执政
vzlr	执意
vzps	搬家
vzqv	搬迁
vzrd	执照
vzrq	挑剔
vzsf	执导
vzte	执行	挑选
vzum	执着
vzvm	挑衅
vzye	执业
vzzn	挑起
wabd	万分
wacm	万能
wadi	供电
waee	万元
wafs	借款
wagi	供应
wahh	借此
waii	万一
wajt	借鉴
wajx	万岁
wako	借口
wakt	万吨
wale	借了
walf	万里
walk	万国
wanq	万物
wanr	傲慢
waoo	供求
waqg	借钱
waqi	万千	供销
waql	借助
wasi	万事
wasu	供水
wata	万年
wavr	万众
wavy	万余
wawq	供货
wawy	万亿
waxc	万维
waxe	供给
waxi	万象
wayd	供需
wayo	借用
wbam	离散
wbdj	离奇
wbdl	侧面
wbek	离职	离合
wbfc	离去
wbgg	离子
wbhq	俗称
wbka	离开
wbkl	离别
wbnq	离婚
wboe	离谱
wboq	俗话
wbps	离家
wbpt	份额
wbql	侧重
wbxg	离线
wbxi	离心
wcdp	领带
wcec	领取
wcff	领土
wcfg	领域
wcfl	领地	倒地
wcfr	倒塌
wcgv	倒退
wchh	仅此
wcip	倒下
wcjv	邻近
wclt	领略
wclu	倒也
wcmf	倒闭
wcmn	倒数
wcnw	领悟
wcoo	俊杰
wcpc	领军
wcps	邻家
wcpy	领袖
wcre	令人
wcsf	领导
wcsg	邻居
wcte	领先
wctq	领衔
wcuo	仅有
wcve	领会
wcwa	仅供
wcwc	仅仅
wcxg	仅限
wcxr	领队
wcyt	倒霉
wdbh	体贴
wdcm	体能
wddl	体面
wdeo	体彩
wdfe	体坛
wdgg	例子
wdhk	优点	体积
wdhn	优秀
wdhx	优惠
wdif	优于
wdir	体温
wdke	体形
wdkm	体现
wdkw	体味
wdli	体力
wdme	体验
wdne	体内
wdnk	例如
wdoe	体检
wdog	优良
wdoy	体谅
wdql	体重
wdrs	优质	体质
wdsa	优异
wdte	优先	例行
wdti	倚天
wdtj	体制
wdud	优美
wdve	体会
wdvk	体操
wdvl	优势
wdvx	体系
wdwm	俺们
wdwq	优化
wdxp	例外	体外
wdxv	优劣
wdyc	优雅
wdym	体育
wdzh	优越
weay	文艺
webi	未必
wecf	未到
wecm	未能
weco	文集
weds	文本
wedt	伴奏
weeo	文采
wefg	文教
wegb	文责
wegc	文库
wege	文革
wehb	文具	文秘
wehu	文科
weia	未满
weim	未来
weip	文学
wekb	文员
wele	未了
welr	文章
wely	偷袭
wemi	未免
wemq	未见
weng	偷情
wenk	文娱
wenq	文物	未婚
wens	偷懒
weoi	文档
weov	舆论
wepe	未完
wepf	偷窥
wepg	文字
were	文人
werm	文明	偷看
wesi	文史
wesk	未知
wesm	文献
wesu	文书
wesy	未尽
wetm	文笔
weum	伴着
weuo	未有	伴有
weur	未曾
wevb	偷拍
wevl	文摘
wewd	文体
wewe	偷偷
wewk	伴侣
wewn	文件
wewq	文化
wewv	文凭
wexc	未经
wexu	伴随
wezo	文中
wfab	佳节
wfan	传世
wfce	传输
wfcf	传到
wfcm	佳能
wfdj	传奇
wfdv	传达
wfec	传动
wfet	传送
wfex	传递
wffb	付费
wffg	佛教
wffs	付款
wfgu	仿古
wfij	传染
wfim	佳丽	传来
wfje	佛山
wfjj	传出	付出
wfme	传闻
wfng	传情
wfns	传承
wfoe	传说
wfof	付诸
wfon	传记
wfqg	付钱
wfqi	传销
wfre	传人
wfsh	仿真	传真
wfve	传授
wfvv	传播
wfvy	传入
wfwf	仿佛
wfwv	佳作
wfxe	传给
wfxg	佳绩
wfxu	佳肴
wfxy	传统
wgbv	食欲
wgcf	感到	做到
wgck	登台
wgda	做大
wgec	感动
wgep	感受	做爱
wgfe	侥幸
wgfn	登场
wgfo	做过
wggi	感应
wggk	做强
wggo	做工
wghb	便秘
wghj	便利
wgib	感激
wgif	做法	便于
wgij	感染
wgik	食堂
wgip	感觉
wgiw	感光
wgje	登山
wgjj	做出
wgjk	便可
wgkc	感叹
wgkk	食品
wgld	感恩
wglx	做梦
wgng	感情	做好
wgnh	便民
wgnj	感慨
wgnq	食物
wgnv	感性
wgnw	感悟
wgoc	债权
wgoe	食谱
wgok	做主
wgom	感想
wgon	登记
wgos	感谢	估计
wgpe	做完
wgpn	感官
wgpq	便宜
wgpt	做客
wgqa	做错
wgqr	做饭
wgqy	感触
wgre	做人	感人
wgrm	感冒
wgsa	登上
wgsi	做事
wgsk	感知
wgtl	债务
wgtm	估算
wgud	债券
wgul	食疗
wguo	便有
wgvc	便携
wgvs	登录
wgvv	便捷
wgwn	做成
wgwt	感伤
wgwv	估价	做作
wgxj	登陆
wgxl	仔细
wgxr	咸阳
wgyk	感言
wgyo	食用
whca	修长
whde	似的
whee	悠远
whep	偏爱
whhl	修炼
whhu	似乎
whih	修正
whkl	修理
whmo	悠闲
whmq	偏见
whnh	修改
whoj	修订
whor	侦查
whpp	修补
whpw	侦察
whqt	修饰
whqu	悠然
whqy	悠久
whsu	似水
whte	候选	修行
whtr	修复
whug	偏差
whuy	修养
whvm	偏向
whvn	悠扬
whvp	修建	侦探
whwb	偏离
whwe	伙伴
whwh	偏偏	悠悠
whwp	偏僻
wiad	倘若
wibv	偿还
wihc	俏皮
wiit	威海
wili	威力
wiml	威胁
wimx	威风
wiqx	威尔
wisg	僵硬
wiwm	威望
wjag	何苦
wjbi	何必
wjbu	何不
wjdf	何在
wjec	齐聚
wjfa	何方
wjfl	仙境	何地
wjgg	仙子
wjho	何以
wjhz	何种
wjie	何尝
wjmn	催眠
wjng	仇恨
wjnv	仙女
wjol	何谓
wjpt	侠客
wjre	仙人
wjrf	何时
wjtf	何等
wjtp	何处
wjuk	何况
wjvg	催生
wjvk	齐全
wjwj	齐齐
wjwk	催促
wjwq	催化
wjyr	齐鲁
wkbi	保卫
wkdg	保存
wkec	赢取
wkhj	赢利
wkir	保温
wkis	保洁
wkjv	促进
wkko	赢球
wklx	保罗
wknm	保姆
wkoi	保证
wkpb	保密
wkpf	保守
wkpg	保定
wkpn	保安
wkps	赢家
wkqd	保留
wkqi	促销
wkql	保重
wkqx	保镖
wkre	保暖
wksl	吝啬
wktp	保管
wktr	赢得
wkuo	保有
wkuy	保养
wkvf	保持
wkvh	保护
wkvk	保全
wkwd	保佑
wkwh	保修
wkwl	促使
wkwn	促成
wkwo	保住
wkwv	保健
wkxe	保险
wkxl	保障
wkyy	保鲜
wlcg	使劲
wlde	他的
wldj	位列
wlek	使命
wlfr	使者
wlfu	倍增
wlgg	位子
wlif	位于
wljj	使出
wlls	位置
wloe	他说
wlom	他想
wlon	使之
wlph	使它
wlps	他家
wlqi	使其
wlqp	使馆
wlre	他人	使人
wlrm	傍晚
wlrn	他所
wlsg	位居
wltr	使得
wlwl	他俩
wlwm	他们
wlxv	他乡
wlyo	使用	他用
wmdl	佩戴
wmmb	佩服
wmmu	盲目
wnan	盛世
wnay	含蓄
wnbd	成分
wnbt	成败
wnca	成长
wncm	仍能
wnda	盛大
wndb	盛典
wndc	成套
wndf	仍在
wndm	盛夏
wnds	成本
wnfr	成都
wnfv	成才
wngl	成功
wnhm	今朝
wnhr	仍旧
wnie	贪污
wnim	含泪
wnjk	仍可
wnka	盛开
wnkb	成员
wnke	成形
wnkj	成型
wnkk	成品
wnle	成了
wnli	成立
wnln	贪婪
wnlo	成果	成龙
wnlx	成效	成交	贪恋
wnmb	伺服
wnmg	含糊
wnnk	假如
wnoj	假设
wnol	成为
wnom	妄想
wnow	成语
wnox	含义
wnpn	贪官
wnpr	盛宴
wnps	成家
wnqm	假期
wnqu	仍然
wnre	成人
wnrg	今后
wnri	今日	含量	假日
wnrm	假冒	今晚
wnsi	仍是
wnsu	念书
wnta	今年	成年
wnte	盛行
wnti	今天	成天
wntv	含笑
wnud	念头
wnuo	仍有	含有
wnus	假装
wnux	仍将
wnve	盛会	仍会
wnvg	今生
wnvk	成全
wnwb	成份
wnwe	仍未
wnwx	成像
wnxg	成绩
wnxi	贪心
wnxk	成名	盛名
wnyd	仍需
wnyg	成熟
wnyk	成群
wnyw	今夜
wnyx	成就
woay	储蓄
wode	我的
wodg	储存
wofh	住址
woge	仪表	休克
wohf	住房
wohu	住户
wohz	休止
wokq	仪器
wolk	我国
womo	休闲
wooe	我说
wool	我校
woom	我想
wops	我家
wopv	住宅
wopw	住宿
worn	住所
wosx	休息
wotf	我等
wotk	伪造
wotl	储备
wotp	住处
wous	伪装
wowl	我俩
wowm	我们
wown	休假
woxi	我心
woxp	住院	我院
woxv	伪劣	我省
woyg	仪式
wqai	低落
wqax	华东
wqbv	低谷
wqce	货车
wqcf	低压	低到
wqde	你的
wqdm	华夏
wqec	货运
wqek	化合
wqfs	货款
wqgj	低廉
wqgo	化工
wqhh	华北
wqic	货源
wqif	低于
wqim	华丽
wqip	低下	低沉	化学
wqir	低温
wqje	华山
wqkk	货品
wqlj	低端
wqlk	货架
wqlm	华商
wqlr	低音
wqmb	化肥
wqme	化验
wqmq	低胸
wqmv	低迷
wqng	你好	您好
wqnq	货物
wqoi	低档
wqol	化为
wqom	低调	你想
wqow	华语
wqps	你家
wqqy	化解
wqre	华人
wqrm	你看
wqsd	华硕
wqse	化身
wqsi	化石
wqsm	华南
wqsn	低声
wqud	低头	华美
wqun	化妆
wqus	化装
wqvj	货币
wqwe	华文
wqwg	低估
wqwm	你们	仰望
wqwn	化成
wqwo	你我
wqwv	华侨	化作	低价
wqxj	低级
wqxk	化名
wqxn	华纳
wqxq	化纤
wqye	华裔
wqzo	华中
wrbu	但不
wrcb	但愿
wrcc	但又
wrfc	但却
wrld	但因
wrlu	但也
wroo	倡议
wrsf	倡导
wrsi	但是
wruo	但有
wrxn	但要
wsgk	倔强
wsjj	伸出
wskj	值班
wsps	祭祀
wsqg	值钱
wssa	伸展
wsso	伸手
wstr	值得
wsvc	什么
wsvm	伸向
wsxp	伸缩
wtcf	侮辱
wtko	伤口
wtpf	伤害
wtre	伤人
wtuc	伤痛
wtug	伤痕
wtvl	伤势
wtwa	伤亡
wtwg	伤感
wtxi	伤心
wueo	五彩
wuii	五一
wule	五四
wumm	五月
wupn	五官
wurv	五星
wusi	五十
wutm	五笔
wuvk	五金
wvbt	作弊
wvck	这台
wvdj	这段
wvek	任命	任职
wver	这儿
wvfb	侵犯
wvff	作坊
wvfg	任教
wvfm	违规
wvfr	作者	违者
wvfs	这款
wvgc	这张
wvgd	这项
wvgg	傻子
wvgu	傻瓜
wvgv	健康
wvhh	这些	违背
wvhk	作战
wvhz	这种
wvif	违法	作法
wvip	这下
wvjj	迈出
wvjv	迈进
wvkh	这叫
wvkk	作品
wvkl	伦理
wvle	傻了
wvlf	这里
wvlk	这回	这部
wvlr	任意	违章
wvlt	侵略
wvlv	这边
wvly	侵袭
wvmd	这类
wvmi	任免
wvmx	作风
wvnc	作怪
wvnq	作物
wvnv	任性
wvoc	侵权
wvoi	凭证
wvol	作为
wvon	作词
wvot	价格
wvoy	这样
wvpf	侵害
wvpi	这片
wvpn	作案
wvps	作家	这家
wvpt	作客
wvqc	侵蚀
wvqg	价钱
wvqm	任期
wvqu	作曲
wvrc	违反
wvrf	这时
wvse	健身
wvsi	这是
wvti	这天
wvtl	任务
wvtm	这笔
wvts	这条
wvtv	傻笑
wvud	健美
wvum	凭着
wvuq	这次
wvus	健壮
wvvc	这么
wvve	这会
wvvh	这个
wvvk	健全
wvvm	迈向	这番
wvvx	这批
wvvy	侵入
wvwa	凭借
wvwb	这份
wvwe	作文
wvwj	任何
wvwl	价位	这位
wvwn	这件
wvws	价值
wvwv	任凭
wvxk	佚名
wvxn	违纪
wvxq	违约
wvye	作业
wvyg	伦敦
wvyk	这群
wvyo	作用	任由
wvyx	这就
wvzj	这般
wwda	伟大
wwlk	俄国
wwre	伟人
wwye	伟业
wxfc	忘却
wxfw	倾城
wxgx	像素
wxkj	倾听
wxle	忘了
wxli	倾力
wxmx	倾慕
wxnb	忘怀
wxng	倾情
wxoj	倾诉
wxon	忘记
wxqi	倾销
wxqk	紊乱
wxvh	忘掉	像个
wxvm	倾向
wxvy	倾斜
wxwc	倾倒
wxxi	倾心
wyce	停车
wydi	停电
wydj	信奉
wydv	信达
wyee	亿元
wyff	代替	信封
wyfs	贷款
wyge	代表
wygg	袋子
wyhr	依旧
wyhx	依稀
wyhz	停止
wyid	停滞
wyif	依法
wyii	信誉
wyip	停下
wykg	信号	代号
wykl	代理
wylb	代办
wylc	停产
wyle	停了
wylx	依恋
wync	伊始
wyof	信访
wyoj	伊朗	停机
wyol	代为
wyos	代谢
wyox	信义
wyqd	停留
wyqu	依然	偶然	俨然
wyqx	偶尔
wyrd	依照
wysm	代码
wysq	依赖	信赖
wysx	信息
wytd	停顿
wytk	依靠
wyto	信箱
wyuq	依次
wyvb	信报
wyvs	依据
wyvv	依托	信托
wywa	亿万
wywl	依偎
wywn	信念	信件
wywo	停住
wywq	信仰
wywv	信任	代价
wywx	偶像
wywy	信贷
wyxi	信心
wyyk	代言
wyyo	信用
wyyv	偶遇
wzdy	仲裁
xadj	陈列
xahr	陈旧
xaoo	陈述
xbfb	缴费
xbfg	凶猛
xbkk	纷呈
xbng	怨恨
xbnn	纷飞
xbqv	纷争
xbso	凶手
xbxb	纷纷	绵绵
xbxn	缴纳
xbxr	绵阳
xbxs	凶杀
xbya	绵羊
xbyk	怨言
xbyn	鸳鸯
xcap	经营	阵营
xccl	经历
xcdb	经典
xcep	经受
xcfb	经费
xcfl	阵地
xcfo	经过
xcik	经常
xciw	经济
xckl	经理
xclm	经商
xclr	经意
xcme	经验
xcoc	维权
xcpv	阵容
xcqd	经贸
xcqi	经销
xcsu	经书
xctp	经管
xcvf	维持
xcvh	维护
xcvx	维系
xcwh	维修
xcxc	阵阵
xcxn	经纪
xcxw	经纬
xcyo	经由
xdii	绍兴
xdkh	尖叫
xdlj	尖端
xdlk	绑架
xdma	希腊
xdnb	缅怀
xdpg	绑定
xdqe	尖锐
xdql	缅甸
xdvg	陌生
xdwm	希望
xedg	缓存
xehh	险些
xehk	缓和
xejj	给出
xenr	缓慢
xeqy	缓解
xeus	隧道
xeuz	缓冲
xexe	缓缓
xeyu	给予
xeyx	险恶
xfai	防范
xfan	尘世
xfbi	防卫
xffc	尘埃
xfff	尘土	尘封
xfgm	防毒
xfgw	防腐
xfhr	防爆
xfhu	防火
xfhz	防止
xfic	防治
xfih	防潮
xfme	绯闻
xfpf	防守
xfpg	防空
xfrx	防晒
xfsu	防水
xftl	防备
xftv	防御
xfuj	防疫
xfuq	防盗
xfvh	防护
xfwo	防伪
xfxg	防线
xfxk	纺织
xgav	红茶
xgaw	红花
xgch	心路历程
xgfo	绕过
xgft	红旗
xgga	限度
xggt	线路
xggu	红豆
xghj	红灯	红利
xghk	线程
xghu	红火
xgif	限于
xgiw	红光
xgiy	红酒
xgks	红叶
xglc	红颜
xglx	绩效
xgnv	线性
xgom	红楼
xgpc	红军
xgpf	隔壁
xgpg	限定
xgpt	限额
xgqb	红色
xgqm	限期
xgqs	红包
xgrf	限时
xgri	限量
xgrv	红星
xgsa	线上
xgsp	线索
xgtj	限制
xgts	线条
xgum	隔着
xgwb	隔离
xgxb	缠绵
xgxf	红尘
xgxg	缠绕
xgxp	红外
xhaf	编著
xhaw	绣花
xhbd	比分
xhck	编辑
xhcl	比较
xhfa	比方
xhfr	编者
xhhk	编程
xhih	纠正
xhjk	皆可
xhke	比喻
xhkg	编号
xhlr	毕竟
xhnf	比特
xhnk	比如
xhoc	编译
xhpb	比赛
xhpi	编写
xhql	比重
xhqu	编曲
xhqx	比尔
xhsg	编剧
xhsm	编码
xhtj	编制
xhuo	皆有
xhve	比拼
xhvf	编排
xhvh	比拟
xhwd	比例
xhxb	纠纷
xhxg	纠缠
xhxk	编织
xhye	毕业
xhyw	多愁善感
xhyx	比率
xhzn	比起
xiab	小巷
xiae	小菜
xian	西藏
xiar	小草
xiax	小区	西欧	西药
xicb	心愿
xice	小车
xicn	小鸡
xido	心态
xidr	小春
xids	小本
xiec	心动
xiep	心爱
xier	小儿
xiex	小弟
xifa	西方
xifg	西域
xifl	心地	心境
xifw	小城	西城
xigg	小子	小巧
xigh	小孩	小店
xigk	小强
xigq	心底
xigt	小路	小麦
xigu	小鬼	西瓜
xigv	小康
xigz	心跳
xihd	心烦
xihf	心扉
xihh	西北
xihx	西餐
xiie	小溪
xiif	小于
xiig	西湖
xiij	小河
xiip	小学
xiiy	西洋
xije	西山	小山
xiji	西甲
xikg	小号
xikj	小型
xikk	小品
xikl	心理
xikt	小吃
xilf	心里
xilh	小站
xili	心力
xilk	西部
xilo	小龙
xilr	心意
xilv	西边
xilx	心思
ximb	西服
xime	西门
ximg	心脏	心眼	小腿
ximq	心胸
ximu	心目
ximx	西风
xinf	小丑
xing	心情
xini	小鸟
xink	心如
xinl	习惯
xinq	小姐
xinw	小妹
xioe	小说
xioj	心机
xiom	心想
xioq	象棋
xioy	小样
xipg	小字
xipj	西宁
xipn	西安
xiqb	小兵
xiqi	小气
xiqs	小镇
xiqv	心急
xirf	小时
xirm	小看
xisa	心上
xisc	小屋
xisd	习题
xisi	心事	小事
xisk	心智
xism	西南
xisn	心声	小声
xiso	小手
xisy	心碎
xiti	象征
xitr	心得
xiuc	心痛
xiud	心头
xiuq	小资
xius	西装	小道
xiut	心疼
xivg	小生	心生
xivh	心灵
xivm	心血
xiwb	习俗	西侧
xiwe	小偷
xiwg	小便
xiwh	小伙
xiwo	心仪
xixi	小心	小小
xixj	西陆
xixq	小组
xixr	夕阳
xixs	小结
xiya	象牙	西亚
xiyc	心酸
xiyu	小雨
xiyv	小雪
xizo	心中
xjfl	陆地
xjkl	级别
xjlf	阿里
xjny	阿姨
xjpc	陆军
xjvl	阿拉
xjxi	陕西
xjxs	陆续
xkaf	名著
xkas	名医
xkce	名车
xkcq	喜欢
xkdj	名列
xkel	名单
xkep	喜爱
xkfw	名城
xkgd	喜庆
xkgg	绳子
xkhj	名利
xkhq	名称
xkii	名誉
xkik	名堂
xkiy	名流
xkji	名师
xkkh	名叫
xkkk	名品
xkmv	名胜
xkne	喜悦
xkng	喜好
xknq	织物
xkol	名校	名为
xkom	名模
xkon	名词	喜讯
xkox	名义
xkpg	名字
xkpi	名片
xkpr	名牌
xkps	名家
xkpt	名额
xkqb	喜迎
xkqi	名气
xkqu	名曲
xkre	名人
xksg	喜剧
xksn	名声
xkuq	名次
xkux	名将
xkvh	名企
xkvs	名录
xkwd	名优
xkwv	名作
xkyk	名言
xkzi	名贵
xlab	细节
xlal	细菌
xlbd	细分
xlbj	细则
xlcf	细致
xlii	嘉兴
xlmg	陪同
xlmn	细数
xlmq	细胞
xlmy	细腻
xloe	细说
xlpg	嘉定
xlpq	嘉宾
xlsr	障碍
xltj	细微
xltk	缔造
xlwe	陪伴
xlwo	陪我
xlwq	细化
xlxi	细心	练习	细小
xlxl	细细
xlyu	细雨
xmac	阴茎
xmdm	继而
xmns	继承
xmog	阴谋
xmrl	阴暗
xmry	阴影
xmti	阴天
xmus	阴道
xmxn	纲要
xmxr	阴阳
xmxs	继续
xmye	阴霾
xmyu	阴雨
xnbu	要不
xncf	要到
xndh	要死
xndp	纽带
xnek	要命
xngx	要素
xnhe	纳税
xnhk	要点
xnhn	纪委
xnho	要以
xnim	要来
xnjc	要紧
xnlk	要回
xnme	要闻
xnmx	纳闷
xnng	要好
xnnu	要买
xnoe	纪检
xnom	要想
xnon	要诀
xnoo	要求	纳米
xnos	要让
xnpu	纪实
xnqg	要钱
xnrm	要看
xnsi	要是	纪事
xntv	纪律
xnvc	要么
xnvs	纪录
xnvy	纳入
xnwc	要领
xnwn	纪念
xnxq	纽约
xnyo	要用
xoer	幼儿
xofg	幼教
xohc	幼稚
xohj	幻灯
xoip	幻觉
xoom	幻想
xory	幻影
xpay	综艺
xpca	院长
xpcm	外观
xpdc	外套
xpdf	外在
xpdl	外面
xpeb	外貌
xpek	综合
xpfl	外地
xpfs	外墙
xpft	绽放
xpge	外表
xpgg	院子
xphu	外科
xpia	外汇
xpih	外婆
xpim	外来
xpjj	外出
xpke	外形
xplk	外国	外部	外加
xplm	外商
xpls	外置
xplv	外边	外界
xplw	外围
xplx	外交
xpne	院内
xpoj	外设
xpol	院校
xpoo	综述
xpow	外语
xppi	缩写
xpqd	外贸
xpqi	外销
xpqs	外包
xpre	外人
xprn	院所
xpsg	缩短
xpsi	院士	外事
xpsp	外壳
xpsu	缩水
xptl	外籍
xpuq	外资
xpve	外援
xpvf	外挂
xpvh	外企
xpvl	外接
xpvm	外向
xpwe	外文
xpwf	外传
xpxb	缤纷
xpxi	缩小
xpye	外衣
xpyv	外遇
xqab	隐蔽
xqan	隐藏	绝世
xqbu	绝不
xqca	组长
xqcf	绝对
xqek	组合
xqfe	绝非
xqgc	纸张
xqhb	隐秘
xqhc	隐私
xqhk	约占
xqhu	绚烂
xqhv	约翰
xqhz	阻止
xqid	绝无
xqim	绚丽
xqji	纸巾
xqke	隐形
xqlf	组团
xqli	阻力
xqlt	组图
xqma	隐瞒
xqng	约好
xqnx	绝妙
xqol	约为
xqpg	约定
xqqb	绝色
xqsa	纸上
xqse	隐身
xqsr	阻碍
xqsu	约束
xqto	纸箱
xqts	纸条
xquo	约有
xquq	陶瓷
xqus	组装
xqvd	绝招
xqve	约会
xqvi	阻挡
xqvp	组建
xqvs	绝技
xqvy	陷入
xqwf	绝佳
xqwm	绝望
xqwn	组成	组件	隐含
xqwy	绝代
xqxc	纤维
xqxj	陷阱
xqxk	组织
xqxl	纤细
xqxq	隐约
xqxx	绝缘
xqye	纸业
xqyy	陶醉
xqzz	隐患
xrai	坠落
xrca	队长
xrck	阳台
xrcm	纵观
xrdc	队友
xrig	阳江
xriw	阳光
xrkb	队员
xroa	纵横
xrpn	心旷神怡
xrpv	纵容
xrqu	纵然
xrvy	坠入
xrwl	纵使
xrww	队伍
xsai	飘落	飘荡
xsal	杀菌
xsce	刹车
xsco	续集
xscw	鼓励
xsdh	杀死
xsec	鼓动
xsek	结合
xsfb	续费
xsgm	杀毒
xshf	票房
xshr	飘香
xsik	鼓掌
xsim	飘渺
xslo	结果
xslx	结交
xsmn	票数
xsmo	飘逸
xsnq	结婚
xsnx	刹那
xsoh	结核
xsok	结识
xsom	鼓楼
xsoq	结构
xsov	结论
xspf	杀害
xspu	结实
xsre	杀人
xsrr	结晶
xssi	绅士
xssm	结尾
xssn	结局
xsso	杀手
xssu	结束
xstd	鼓舞
xstm	结算
xsvn	飘扬
xsvs	票据
xswe	结伴
xswn	结成
xswt	杀伤
xswv	票价
xsxx	杀戮
xsyv	飘雪
xsyw	飘零
xszn	鼓起
xtai	降落
xtcf	降至	降到
xthk	终点
xthz	终止
xtif	终于
xtih	纯正
xtir	降温
xtis	纯洁
xtjg	降幅
xtjt	降临
xtlj	终端
xtmy	纯粹
xtng	纯情
xtoj	终极
xtpj	终究
xtql	隆重
xtri	终日
xtse	终身
xtsh	纯真
xtsy	纯属
xtum	覆盖
xtuq	纯净
xtux	终将
xtvg	终生
xtwn	终成
xtwq	降低
xtwv	降价
xtxd	缝纫
xtxs	终结
xtxx	缝隙
xuai	堕落
xufl	随地
xujb	随即
xulr	随意
xumx	随风
xuoj	随机
xuom	随想
xuon	随之
xurf	随时
xurg	随后
xuse	随身
xuso	随手
xutm	随笔
xutp	随处
xuum	随着
xuwg	随便
xuxi	随心
xuxx	随缘
xval	绿茵
xvav	绿茶
xvbx	少爷
xvca	省长
xvdi	省电
xvdj	阶段
xver	少儿
xvfc	除去
xvfe	除非
xvff	乡土
xvfl	绿地
xvgu	绿豆
xvhj	绿灯
xvhn	省委
xvif	少于
xvil	绘画
xvip	乡下
xvit	绿洲
xvks	绿叶
xvle	除了
xvli	少林
xvll	少男
xvls	乡亲
xvlt	绘图	省略
xvmn	少数
xvmq	少见
xvne	省内
xvnv	少女	少妇
xvoe	阶梯
xvof	乡村
xvov	少许
xvqb	绿色
xvqg	省钱
xvqs	乡镇
xvri	少量
xvrs	劣质
xvse	阶层
xvta	少年
xvtj	绘制
xvuo	少有
xvve	省会
xvvl	劣势
xvwb	省份
xvwq	绿化
xvxi	除夕
xvxj	阶级	省级
xvxp	除外
xvyj	省市
xwdp	附带
xwjv	附近
xwlk	附加
xwlt	附图
xwsa	附上
xwsy	附属
xwuo	附有
xwvs	附录
xwwn	附件
xwzo	附中
xxbd	缘分
xxca	多长
xxda	多大
xxdv	多达
xxec	多云
xxee	多元
xxej	多半
xxeo	多彩
xxfa	多方
xxgd	多项
xxgt	缘故	丝路
xxhk	多点
xxhy	维多利亚
xxhz	多种
xxif	多于
xxlc	多变
xxlk	多加	多国
xxma	羽毛
xxmm	多月
xxmn	多数
xxmx	丝网
xxng	多情	多好
xxos	多谢
xxoy	多样
xxpi	丝袜
xxps	多家
xxql	多重
xxqy	多久
xxre	多人
xxrf	多时
xxse	多层
xxta	多年
xxtr	多得
xxuq	多次
xxvc	多么
xxvh	多个
xxvy	多余
xxwg	多做
xxwj	缘何
xxwl	多位
xxxg	羽绒	纱线
xxxk	多名
xxxm	丝绸
xxxv	多少
xxym	多高
xxyo	多用
xxyp	丝毫
xxzn	缘起
xyic	统治
xyii	统一
xyos	统计
xytd	统筹
xyxy	统统
yaci	牙齿
yado	亚太
yafw	羊城
yahc	羊皮
yait	亚洲
yanr	羊肉
yapc	亚军
yapm	央视
yasj	牙刷
yate	央行
yayp	牙膏
ycai	震荡
yccf	雅致
ycdb	雅典
ycec	震动
ychj	雅虎
yclx	雅思
ycnn	酸奶
ycny	震惊
ycvw	震撼
ydaq	预警
ydck	预售
ydib	预测
ydjt	预览
ydmq	预见
ydmu	预料
ydoj	预订	预设
ydoo	需求
ydos	预计
ydpg	预定
ydpn	预案
ydqd	预留
ydqm	预期
ydsi	预示
ydsk	预知
ydte	预先	预选
ydtk	预告
ydtl	预备
ydtm	预算
ydvb	预报
ydwf	预付
ydwg	预感
ydxf	预防
ydxn	需要
ydxq	预约
ydyk	预言
ydyu	鱿鱼
yebd	充分
yedi	充电
yefr	业者
yeia	充满
yeii	充沛
yeik	衣裳
yeiv	充当
yejo	充斥
yekh	充足
yelv	业界
yemb	衣服
yene	业内
yenq	衣物
yeoa	衣柜
yeok	业主
yepu	充实
yeqi	充气
yetl	业务
yeum	衣着
yevy	业余
yewg	衣食
yews	充值
yewt	哀伤
yexg	业绩
yeyo	酝酿
ygdl	露面
ygep	享受
yghb	敦煌
yghk	露点
ygjj	露出
ygkk	霸王
ygok	霸主
ygqi	霸气
ygre	熟人
ygsk	熟知
ygti	露天
yguo	享有
ygus	霸道
ygvm	熟悉
ygxl	熟练
ygyo	享用
yihx	乙烯
yimg	乙肝
yjax	市区
yjca	市长
yjcg	霓虹
yjdl	市面
yjfn	市场
yjhn	市委
yjih	市政
yjlf	市里
yjne	市内
yjnh	市民
yjws	市值
ykay	群英
ykdc	群雄
ykfc	群发
ykgg	君子
ykng	言情
yknj	群岛
ykov	言论
ykow	言语
ykox	襄樊
ykqk	言辞
ykrv	群星
ykte	言行
ykvr	群众
ykwd	群体
ykxq	群组
ykyu	鳄鱼
yldv	雷达
ylhj	亨利
yloa	雷诺
ylom	烹调
ylqv	烹饪
ylvu	颤抖
ylyv	雷霆
ymal	高薪
ymbd	高分
ymcb	高原
ymcf	高压
ymda	高大
ymdc	高雄
ymdv	高达
ymek	高职
ymer	育儿
ymfg	高考
ymga	高度
ymgk	高强
ymhh	高频
ymif	高于
ymig	高涨
ymih	高潮
ymii	高兴
ymim	高尚
ymir	高温
ymje	高山
ymjk	高歌
ymjt	高峰
ymkv	敲响
ymlj	高端
ymlr	高音
ymls	高新
ymlx	高效
ymme	敲门
ymoi	高档
ymol	高校
ymom	高楼	高调
ympg	高空	敲定
ympn	高官
ympt	高额
ymqu	盎然
ymre	育人
ymrm	高明
ymrq	高昂
ymse	高层
ymso	高手
ymsv	高速
ymtf	高等
ymtp	高处
ymvd	高招
ymvj	敲打
ymwl	高位
ymwq	高低
ymwv	高价
ymxj	高级
ymyc	高雅
ymzd	高超
ymzi	高贵
ymzo	高中
yncf	配对
yndc	配套
yndi	配电
ynek	配合
ynet	配送
ynfa	配方
ynlr	配音
ynls	配置
ynpt	配额
ynqx	配乐
ynqy	配角
ynsa	配上
yntj	配制
yntl	配备
ynwn	配件
ynwy	配偶
yoax	用药
yoce	用车
yocf	用到
yodf	用在
yodi	用电
yofl	用地
yofo	用过
yogl	用功
yohb	用具
yohh	由此
yoho	用以
yohu	用户
yohx	用餐
yoif	由于	用于	用法
yoim	用来	由来
yojk	亦可
yokk	用品
yoli	用力
yolr	用意
yong	用好
yoow	用语
yope	用完
yore	用人
yori	用量
yosa	用上
yoso	用手
yosu	用水
yosy	用尽
yotp	用处
youo	亦有
yovy	用途
yowo	由我
yowq	由你
yoxi	用心	迹象
yoxq	用纸
yoyz	由衷
ypbu	毫不
ypga	亮度
yphk	亮点
yphx	毫秒
ypid	毫无
ypim	亮丽
ypme	豪门
ypng	豪情
ypom	亮相
ypoo	豪杰	毫米
yppv	豪宅
ypwq	豪华
ypyc	霹雳
yrfh	衰老
yrgv	衰退
yrim	醒来
yrmu	醒目
yrns	鲁迅
yrnw	醒悟
yrva	晋升
yrxj	晋级
ytep	酷爱
ytwh	酷似
yuhg	雨季
yuho	予以
yuif	善于
yulr	善意
yumd	鱼类
yuog	善良
yusu	雨水
yuti	雨天
yuve	雨伞
yvaw	雪花
yvba	雪白
yvcc	遇难
yvcf	遇到
yvcq	柔软
yvcw	严厉
yvfl	雪地
yvgu	柔弱
yvhk	柔和
yvjc	严峻
yvje	雪山
yvls	严禁
yvmq	遇见
yvng	柔情
yvoj	严谨
yvot	严格
yvpb	严密
yvql	严重
yvrs	矛盾
yvsa	遇上
yvsu	严肃
yvud	柔美
yvvf	矜持
ywck	零售
ywhk	零点
ywlf	夜里
ywmj	夜幕
ywmr	夜间
ywpg	夜空
ywqb	夜色
ywqu	夜曲
ywrm	夜晚
ywrv	零星
ywry	夜景
ywwg	零食
ywwn	零件
ywyw	夜夜
yxas	就医
yxbq	邮购
yxbu	就不
yxcm	就能
yxcv	就连
yxdi	邮电
yxdr	愚蠢
yxek	就职
yxfb	邮费
yxfg	邪教
yxfl	就地
yxfr	京都
yxfw	京城
yxgl	恶魔
yxgm	恶毒
yxhh	就此
yxih	邮政	京沪
yxim	就来
yxin	就与
yxjv	就近
yxlr	恶意
yxmk	就问
yxnb	就怕
yxng	就好
yxnt	畜牧
yxnv	恶性
yxoe	就说
yxoj	玄机
yxom	就想
yxos	就读	就让
yxov	就诊
yxpd	邮寄
yxre	愚人
yxrm	就看
yxsg	京剧
yxsi	就是
yxsn	邮局
yxte	率先	就行
yxtm	就算
yxto	邮箱
yxux	就将
yxve	就会
yxvm	就向
yxwc	率领
yxwn	邮件
yxwq	恶化	京华
yxwx	就像
yxxf	就绪
yxxh	邮编
yxxi	恶心	就象
yxxn	就要
yxxs	邮票
yxxv	恶劣
yxye	就业
yxyx	邪恶
yxzh	就越
yyaw	鲜花
yyfq	鲜艳
yyiq	鲜活
yyiy	醉酒
yyrm	鲜明
yyvm	鲜血
yyxg	鲜红
yzxi	衷心
zafu	丈夫
zdai	超薄
zdfo	超过
zdgk	超强
zdhh	超频
zdhu	超乎
zdjj	超出
zdjo	超凡
zdos	超标
zdre	超人
zdum	超前
zdws	超值
zdxj	超级
zdyj	超市
zdzh	超越
zekw	趣味
zeme	趣闻
zesi	趣事
zgcf	赶到
zgjc	赶紧
zglk	赶回
zgnn	赶快
zgsa	赶上
zgto	赶往
zhfc	越发
zhfo	越过
zhlf	越野
zhsm	越南
ziap	自营
ziba	自白
zicb	自愿
zidf	自在
zidp	自带
ziec	自动
ziey	自尊
zifb	自费
zifc	自发
zifg	自考
zifh	遗址
zift	贵族
zigb	自贡	自责
zigk	自强
zigu	自古
zihc	自私
zihh	自此
zihq	自称
ziic	自治
ziip	自觉	自学
ziis	遗漏
zikl	自理
zilc	遗产
zili	自立
zilx	自恋
zink	自如
zinn	自己	贵妃
zinw	遗憾
ziok	自主
zioo	自救	自述
zior	自认
zipq	贵宾
zips	自家
ziqb	自负
ziqd	遗留
ziql	贵重	自助
ziqu	自然
zirr	自从	自曝
zirs	自卑
zise	自身
zisk	自知
zite	自行	自选
zitj	自制
zitv	贵州	自律
ziuo	自有
zivb	自创
zivd	自拔
zivf	遗失
zivp	自控
ziwd	遗体
ziwf	遗传	自传
ziwo	自我
ziwx	遗忘
ziwy	自信
zixh	自编
zixi	自习
zixr	贵阳
zixs	自杀
ziya	遗弃
ziyo	自由	遗迹
ziyp	自豪
zjsa	船上
zjzb	船舶
zlal	中国共产党
zmft	盘旋
zmgg	盘子
zmhk	盘点
zmxr	舰队
znar	起草
zncf	起到
zngo	起床
znhh	起步
znhk	起点
znhu	起火
znic	起源
znim	起来
znnc	起始
znnn	起飞
znoj	起诉
znox	起义
znpd	起初
znql	起重
znse	起身
znsm	起码
zntd	起舞
znwq	起伏
znxk	起名
zoab	中共
zoas	中医
zoax	中东	中药
zoay	中英
zocb	中原
zocf	中转
zoda	中大
zodf	走在
zoec	走动
zofa	中方
zofg	中考
zofo	走过	中专
zogm	中毒
zogo	走廊
zogt	走路
zohc	走私
zohh	中秋
zohm	走遍
zohx	中餐
zohz	中止
zoii	中兴
zoip	中学
zoiw	走光
zoje	中山
zojj	走出
zojv	走进	走近
zoka	走开
zokj	中型
zole	走了
zoli	中立
zolk	中国
zolr	中意
zomn	中断
zomr	中间
zomx	中风
zonv	中性
zooa	中枢
zoof	走访
zooi	中档
zoos	中标
zoqm	中期
zoqr	中旬
zori	中日
zosa	走上
zose	中层
zosm	中南
zota	中年
zotf	中等
zoti	中天
zoud	中美
zoux	中将	中奖
zovg	中午
zovj	中介
zovl	走势
zovm	走向
zovy	中途
zowe	中文
zowq	中华	走低
zoxg	走红
zoxi	中心	中小	中西
zoxj	中级
zoxp	中外
zoxr	中队
zoya	中央	中亚
zoyg	中式
zoyo	中用
zpud	赴美
zqif	趋于
zqvl	趋势
zqvm	趋向
ztzv	患得患失
zvgq	逃跑
zvjj	逃出
zvme	逃脱
zvoj	趁机
zvpv	逃避
zvum	趁着
zvvg	逃生
zvwa	逃亡
zvwb	逃离
zvzo	逃走
zxif	忠于
zxow	忠诚
zxpu	忠实
zxtk	忠告
zyit	航海
zykj	航班
zymu	航母
zypg	航空
zyte	航行
zyti	航天
zyxg	航线
zyzd	自由自在
zzfr	患者
zzsa	患上
zzui	患病
zzuo	患有
rwz	の
zsh	㍿
pg	
cmd	⌘
ctl	⌃
opt	⌥
sft	⇧
cap	⇪
ret	↩
etr	⌅
ht	♠	♤   
hx	♥	♡
mh	♣	♧
fp	♦	♢
yy	♪ ♫ ♬ ♭ ♮ ♯
mtj	▶ ◼ ☊
gjq	♔ ♕ ♖ ♗ ♘ ♙ ♚ ♛ ♜ ♝ ♞ ♟
xby	₁ 
xbe	₂
xbs	₃
xbs	₄
xbw	₅
xbl	₆
xbq	₇
xbb	₈
xbj	₉
xbl	₀
xbj	₊
xbj	₋
xbd	₌
xbz	₍
xby	₎
xba	ₐ
xbe	ₑ
xbo	ₒ
xbx	ₓ
xbe	ₔ
byz	♈
jnz	♉
szz	♊
jxz	♋
szz	♌
cnz	♍
tpz	♎
txz	♏
ssz	♐
mxz	♑
spz	♒
syz	♓
zy	⿰
sx	⿱
zzy	⿲
szx	⿳
bw	⿴
sbw	⿵
xbw	⿶
zbw	⿷
zsb	⿸
ysb	⿹
zxb	⿺
jc	⿻
zyf	ㄅ ㄆ ㄇ ㄈ ㄉ ㄊ ㄋ ㄌ ㄍ ㄎ ㄏ ㄐ ㄑ ㄒ ㄓ ㄔ ㄕ ㄖ ㄗ ㄘ ㄙ ㄧ ㄨ ㄩ ㄚ ㄛ ㄜ ㄝ ㄞ ㄟ ㄠ ㄡ ㄢ ㄣ ㄤ ㄥ ㄦ
dxl	Α Β Γ Δ Ε Ζ Η Θ Ι Κ Λ Μ Ν Ξ Ο Π Ρ Σ Τ Υ Φ Χ Ψ Ω
dkh	「」 『』 【】 〖〗 《》 〈〉 “” ‘’ （） ［］ 〔〕 ｛｝
du	°
ssd	℃
fsd	℉
km	㎞ 
cm	㎝ 
mm	㎜ 
um	㎛ 
nm	㎚
fm	㎙
kmf	㎢
mf	㎡
cmf	㎠
mmf	㎟
kml	㎦
ml	㎥
cml	㎤
mml	㎣
mms	㎧
mms	㎨
ug	㎍
mg	㎎
kg	㎏
kb	㎅
mb	㎆
gb	㎇
ps	㎰
ns	㎱
us	㎲
ms	㎳
hz	㎐
khz	㎑
mhz	㎒
ghz	㎓
thz	㎔
ps	㎩
kpa	㎪
mpa	㎫
gpa	㎬
pv	㎴
np	㎵
uv	㎶
mv	㎷
kv	㎸
mv	㎹
pw	㎺
nw	㎻
uw	㎼
mw	㎽
kw	㎾
mw	㎿
ko	㏀
mo	㏁
am	㏂
ln	㏑
log	㏒
ph	㏗
pm	㏘
yd	⒈ 
ed	⒉ 
sd	⒊ 
sd	⒋ 
wd	⒌ 
ld	⒍ 
qd	⒎ 
bd	⒏ 
jd	⒐ 
sd	⒑ 
syd	⒒ 
sed	⒓ 
ssd	⒔ 
ssd	⒕ 
swd	⒖ 
sld	⒗ 
sqd	⒘ 
sbd	⒙ 
sjd	⒚ 
esd	⒛
ye	½
hb	¤
my	＄
yb	￡
rmb	¥
cz	￠
ry	￥
oy	€
jn	¢
ynd	₫
hy	₩
zj	§
aef	α
bt	β
gm	γ	
czt	艹
zze	辶
ldp	刂
bzt	勹
sdd	灬
lds	冫
